geoid,GEOID10,name,B25003001,"B25003001, Error",B25003002,"B25003002, Error",B25003003,"B25003003, Error"
14000US06037101110,6037101110,"Census Tract 1011.10, Los Angeles, CA",1575,90,843,117,732,127
14000US06037101122,6037101122,"Census Tract 1011.22, Los Angeles, CA",1312,63,1072,108,240,96
14000US06037101210,6037101210,"Census Tract 1012.10, Los Angeles, CA",2297,98,401,146,1896,168
14000US06037101220,6037101220,"Census Tract 1012.20, Los Angeles, CA",1357,57,535,98,822,88
14000US06037101300,6037101300,"Census Tract 1013, Los Angeles, CA",1445,93,1255,105,190,78
14000US06037101400,6037101400,"Census Tract 1014, Los Angeles, CA",1355,129,939,144,416,143
14000US06037102103,6037102103,"Census Tract 1021.03, Los Angeles, CA",692,35,461,75,231,65
14000US06037102104,6037102104,"Census Tract 1021.04, Los Angeles, CA",1230,91,927,114,303,105
14000US06037102105,6037102105,"Census Tract 1021.05, Los Angeles, CA",559,35,302,62,257,59
14000US06037102107,6037102107,"Census Tract 1021.07, Los Angeles, CA",1345,47,957,114,388,102
14000US06037103101,6037103101,"Census Tract 1031.01, Los Angeles, CA",897,56,769,69,128,56
14000US06037103102,6037103102,"Census Tract 1031.02, Los Angeles, CA",1623,76,1195,136,428,130
14000US06037103200,6037103200,"Census Tract 1032, Los Angeles, CA",2226,110,1369,162,857,144
14000US06037103300,6037103300,"Census Tract 1033, Los Angeles, CA",1288,74,1131,89,157,65
14000US06037103400,6037103400,"Census Tract 1034, Los Angeles, CA",2461,103,1562,196,899,183
14000US06037104103,6037104103,"Census Tract 1041.03, Los Angeles, CA",849,47,695,68,154,62
14000US06037104105,6037104105,"Census Tract 1041.05, Los Angeles, CA",1646,77,869,101,777,109
14000US06037104108,6037104108,"Census Tract 1041.08, Los Angeles, CA",1459,46,572,90,887,80
14000US06037104124,6037104124,"Census Tract 1041.24, Los Angeles, CA",1232,79,948,109,284,99
14000US06037104201,6037104201,"Census Tract 1042.01, Los Angeles, CA",941,45,663,84,278,77
14000US06037104203,6037104203,"Census Tract 1042.03, Los Angeles, CA",1169,61,578,97,591,108
14000US06037104204,6037104204,"Census Tract 1042.04, Los Angeles, CA",764,35,496,63,268,63
14000US06037104310,6037104310,"Census Tract 1043.10, Los Angeles, CA",849,60,635,68,214,61
14000US06037104320,6037104320,"Census Tract 1043.20, Los Angeles, CA",1331,55,632,153,699,145
14000US06037104401,6037104401,"Census Tract 1044.01, Los Angeles, CA",664,46,410,58,254,64
14000US06037104403,6037104403,"Census Tract 1044.03, Los Angeles, CA",665,51,415,86,250,92
14000US06037104404,6037104404,"Census Tract 1044.04, Los Angeles, CA",678,39,309,53,369,63
14000US06037104500,6037104500,"Census Tract 1045, Los Angeles, CA",625,62,465,70,160,69
14000US06037104610,6037104610,"Census Tract 1046.10, Los Angeles, CA",703,44,452,53,251,57
14000US06037104620,6037104620,"Census Tract 1046.20, Los Angeles, CA",661,61,406,62,255,65
14000US06037104701,6037104701,"Census Tract 1047.01, Los Angeles, CA",926,48,201,58,725,74
14000US06037104703,6037104703,"Census Tract 1047.03, Los Angeles, CA",572,57,213,57,359,69
14000US06037104704,6037104704,"Census Tract 1047.04, Los Angeles, CA",1199,63,743,104,456,114
14000US06037104810,6037104810,"Census Tract 1048.10, Los Angeles, CA",1095,74,797,130,298,134
14000US06037104821,6037104821,"Census Tract 1048.21, Los Angeles, CA",795,42,422,59,373,64
14000US06037104822,6037104822,"Census Tract 1048.22, Los Angeles, CA",625,42,209,44,416,46
14000US06037106010,6037106010,"Census Tract 1060.10, Los Angeles, CA",959,47,729,75,230,69
14000US06037106020,6037106020,"Census Tract 1060.20, Los Angeles, CA",1451,70,1186,129,265,108
14000US06037106111,6037106111,"Census Tract 1061.11, Los Angeles, CA",1298,81,1151,123,147,91
14000US06037106112,6037106112,"Census Tract 1061.12, Los Angeles, CA",1447,100,1184,136,263,122
14000US06037106113,6037106113,"Census Tract 1061.13, Los Angeles, CA",982,58,784,102,198,92
14000US06037106114,6037106114,"Census Tract 1061.14, Los Angeles, CA",1594,83,703,96,891,103
14000US06037106403,6037106403,"Census Tract 1064.03, Los Angeles, CA",828,76,664,84,164,75
14000US06037106405,6037106405,"Census Tract 1064.05, Los Angeles, CA",1184,92,468,117,716,150
14000US06037106406,6037106406,"Census Tract 1064.06, Los Angeles, CA",1660,121,1268,153,392,125
14000US06037106407,6037106407,"Census Tract 1064.07, Los Angeles, CA",913,39,204,54,709,68
14000US06037106408,6037106408,"Census Tract 1064.08, Los Angeles, CA",956,48,179,59,777,75
14000US06037106510,6037106510,"Census Tract 1065.10, Los Angeles, CA",1635,85,1129,154,506,152
14000US06037106520,6037106520,"Census Tract 1065.20, Los Angeles, CA",1433,71,983,119,450,116
14000US06037106603,6037106603,"Census Tract 1066.03, Los Angeles, CA",990,40,867,55,123,51
14000US06037106604,6037106604,"Census Tract 1066.04, Los Angeles, CA",1230,70,587,100,643,106
14000US06037106641,6037106641,"Census Tract 1066.41, Los Angeles, CA",794,22,717,44,77,37
14000US06037106642,6037106642,"Census Tract 1066.42, Los Angeles, CA",1034,66,933,87,101,66
14000US06037106643,6037106643,"Census Tract 1066.43, Los Angeles, CA",1355,28,1229,79,126,79
14000US06037106645,6037106645,"Census Tract 1066.45, Los Angeles, CA",1135,80,1036,100,99,63
14000US06037106646,6037106646,"Census Tract 1066.46, Los Angeles, CA",967,39,870,50,97,44
14000US06037106648,6037106648,"Census Tract 1066.48, Los Angeles, CA",1084,52,475,79,609,90
14000US06037106649,6037106649,"Census Tract 1066.49, Los Angeles, CA",697,38,531,57,166,48
14000US06037107010,6037107010,"Census Tract 1070.10, Los Angeles, CA",735,44,561,53,174,53
14000US06037107020,6037107020,"Census Tract 1070.20, Los Angeles, CA",1229,83,904,114,325,116
14000US06037108101,6037108101,"Census Tract 1081.01, Los Angeles, CA",777,38,645,56,132,52
14000US06037108102,6037108102,"Census Tract 1081.02, Los Angeles, CA",1217,53,1001,114,216,107
14000US06037108103,6037108103,"Census Tract 1081.03, Los Angeles, CA",1016,73,927,84,89,60
14000US06037108104,6037108104,"Census Tract 1081.04, Los Angeles, CA",570,37,480,41,90,49
14000US06037108201,6037108201,"Census Tract 1082.01, Los Angeles, CA",1847,83,1497,132,350,114
14000US06037108202,6037108202,"Census Tract 1082.02, Los Angeles, CA",2723,138,1897,149,826,150
14000US06037109100,6037109100,"Census Tract 1091, Los Angeles, CA",772,42,576,54,196,51
14000US06037109200,6037109200,"Census Tract 1092, Los Angeles, CA",944,79,748,89,196,93
14000US06037109300,6037109300,"Census Tract 1093, Los Angeles, CA",920,43,767,61,153,63
14000US06037109400,6037109400,"Census Tract 1094, Los Angeles, CA",1113,41,794,109,319,100
14000US06037109500,6037109500,"Census Tract 1095, Los Angeles, CA",1038,76,590,107,448,129
14000US06037109601,6037109601,"Census Tract 1096.01, Los Angeles, CA",1281,81,1085,93,196,87
14000US06037109603,6037109603,"Census Tract 1096.03, Los Angeles, CA",1314,78,736,128,578,132
14000US06037109604,6037109604,"Census Tract 1096.04, Los Angeles, CA",918,44,734,70,184,70
14000US06037109700,6037109700,"Census Tract 1097, Los Angeles, CA",1366,67,1147,105,219,97
14000US06037109800,6037109800,"Census Tract 1098, Los Angeles, CA",1451,66,1066,116,385,114
14000US06037111100,6037111100,"Census Tract 1111, Los Angeles, CA",941,43,735,59,206,48
14000US06037111201,6037111201,"Census Tract 1112.01, Los Angeles, CA",1121,41,987,78,134,71
14000US06037111202,6037111202,"Census Tract 1112.02, Los Angeles, CA",1763,113,1243,127,520,138
14000US06037111204,6037111204,"Census Tract 1112.04, Los Angeles, CA",1956,55,1878,66,78,47
14000US06037111205,6037111205,"Census Tract 1112.05, Los Angeles, CA",1327,51,706,110,621,117
14000US06037111206,6037111206,"Census Tract 1112.06, Los Angeles, CA",1503,67,1412,96,91,75
14000US06037111301,6037111301,"Census Tract 1113.01, Los Angeles, CA",2773,141,892,130,1881,161
14000US06037111302,6037111302,"Census Tract 1113.02, Los Angeles, CA",1801,79,906,119,895,106
14000US06037111400,6037111400,"Census Tract 1114, Los Angeles, CA",2888,100,1087,169,1801,181
14000US06037113101,6037113101,"Census Tract 1131.01, Los Angeles, CA",1112,40,898,75,214,75
14000US06037113102,6037113102,"Census Tract 1131.02, Los Angeles, CA",981,34,937,42,44,30
14000US06037113211,6037113211,"Census Tract 1132.11, Los Angeles, CA",1678,52,1382,102,296,96
14000US06037113212,6037113212,"Census Tract 1132.12, Los Angeles, CA",1084,58,626,91,458,99
14000US06037113213,6037113213,"Census Tract 1132.13, Los Angeles, CA",1695,54,1026,120,669,121
14000US06037113231,6037113231,"Census Tract 1132.31, Los Angeles, CA",816,40,665,53,151,57
14000US06037113232,6037113232,"Census Tract 1132.32, Los Angeles, CA",1399,61,1202,107,197,95
14000US06037113233,6037113233,"Census Tract 1132.33, Los Angeles, CA",2534,125,622,140,1912,173
14000US06037113234,6037113234,"Census Tract 1132.34, Los Angeles, CA",1508,107,746,96,762,113
14000US06037113235,6037113235,"Census Tract 1132.35, Los Angeles, CA",711,50,473,79,238,73
14000US06037113237,6037113237,"Census Tract 1132.37, Los Angeles, CA",1458,89,940,85,518,68
14000US06037113301,6037113301,"Census Tract 1133.01, Los Angeles, CA",1287,121,605,70,682,118
14000US06037113303,6037113303,"Census Tract 1133.03, Los Angeles, CA",1407,33,1234,86,173,82
14000US06037113321,6037113321,"Census Tract 1133.21, Los Angeles, CA",2544,29,563,142,1981,149
14000US06037113322,6037113322,"Census Tract 1133.22, Los Angeles, CA",1449,32,1150,115,299,121
14000US06037113401,6037113401,"Census Tract 1134.01, Los Angeles, CA",1972,63,1372,122,600,116
14000US06037113421,6037113421,"Census Tract 1134.21, Los Angeles, CA",2127,70,398,94,1729,126
14000US06037113422,6037113422,"Census Tract 1134.22, Los Angeles, CA",2101,128,1135,137,966,150
14000US06037115101,6037115101,"Census Tract 1151.01, Los Angeles, CA",1656,87,1542,88,114,65
14000US06037115103,6037115103,"Census Tract 1151.03, Los Angeles, CA",28,21,0,12,28,21
14000US06037115104,6037115104,"Census Tract 1151.04, Los Angeles, CA",1915,121,481,83,1434,113
14000US06037115201,6037115201,"Census Tract 1152.01, Los Angeles, CA",2681,150,761,142,1920,195
14000US06037115202,6037115202,"Census Tract 1152.02, Los Angeles, CA",1913,85,846,117,1067,129
14000US06037115301,6037115301,"Census Tract 1153.01, Los Angeles, CA",1653,99,917,112,736,136
14000US06037115302,6037115302,"Census Tract 1153.02, Los Angeles, CA",1056,34,357,46,699,56
14000US06037115401,6037115401,"Census Tract 1154.01, Los Angeles, CA",1933,96,750,126,1183,136
14000US06037115403,6037115403,"Census Tract 1154.03, Los Angeles, CA",1038,52,349,65,689,85
14000US06037115404,6037115404,"Census Tract 1154.04, Los Angeles, CA",860,46,400,68,460,80
14000US06037117101,6037117101,"Census Tract 1171.01, Los Angeles, CA",1465,35,1012,87,453,82
14000US06037117102,6037117102,"Census Tract 1171.02, Los Angeles, CA",802,43,560,63,242,65
14000US06037117201,6037117201,"Census Tract 1172.01, Los Angeles, CA",1239,60,393,76,846,85
14000US06037117202,6037117202,"Census Tract 1172.02, Los Angeles, CA",814,60,648,61,166,49
14000US06037117301,6037117301,"Census Tract 1173.01, Los Angeles, CA",1189,71,934,107,255,90
14000US06037117302,6037117302,"Census Tract 1173.02, Los Angeles, CA",1728,61,1340,104,388,93
14000US06037117303,6037117303,"Census Tract 1173.03, Los Angeles, CA",1049,41,858,97,191,92
14000US06037117404,6037117404,"Census Tract 1174.04, Los Angeles, CA",1362,26,989,123,373,123
14000US06037117405,6037117405,"Census Tract 1174.05, Los Angeles, CA",876,45,43,24,833,52
14000US06037117407,6037117407,"Census Tract 1174.07, Los Angeles, CA",959,35,13,14,946,36
14000US06037117408,6037117408,"Census Tract 1174.08, Los Angeles, CA",858,37,114,36,744,50
14000US06037117510,6037117510,"Census Tract 1175.10, Los Angeles, CA",968,77,143,59,825,85
14000US06037117520,6037117520,"Census Tract 1175.20, Los Angeles, CA",1077,31,175,45,902,52
14000US06037117530,6037117530,"Census Tract 1175.30, Los Angeles, CA",1649,29,387,78,1262,81
14000US06037119001,6037119001,"Census Tract 1190.01, Los Angeles, CA",994,42,729,75,265,69
14000US06037119002,6037119002,"Census Tract 1190.02, Los Angeles, CA",1736,79,1169,122,567,131
14000US06037119201,6037119201,"Census Tract 1192.01, Los Angeles, CA",882,54,678,64,204,75
14000US06037119202,6037119202,"Census Tract 1192.02, Los Angeles, CA",1056,63,776,98,280,93
14000US06037119310,6037119310,"Census Tract 1193.10, Los Angeles, CA",1234,29,592,89,642,94
14000US06037119320,6037119320,"Census Tract 1193.20, Los Angeles, CA",1235,73,361,68,874,89
14000US06037119340,6037119340,"Census Tract 1193.40, Los Angeles, CA",1027,34,12,15,1015,35
14000US06037119341,6037119341,"Census Tract 1193.41, Los Angeles, CA",822,24,269,48,553,51
14000US06037119342,6037119342,"Census Tract 1193.42, Los Angeles, CA",758,28,362,49,396,47
14000US06037119400,6037119400,"Census Tract 1194, Los Angeles, CA",1160,42,938,94,222,87
14000US06037119700,6037119700,"Census Tract 1197, Los Angeles, CA",1302,69,1075,105,227,101
14000US06037119800,6037119800,"Census Tract 1198, Los Angeles, CA",1486,41,1084,107,402,104
14000US06037119900,6037119900,"Census Tract 1199, Los Angeles, CA",1242,62,1019,88,223,82
14000US06037120010,6037120010,"Census Tract 1200.10, Los Angeles, CA",747,19,395,49,352,56
14000US06037120020,6037120020,"Census Tract 1200.20, Los Angeles, CA",1168,38,182,70,986,79
14000US06037120030,6037120030,"Census Tract 1200.30, Los Angeles, CA",734,33,47,25,687,41
14000US06037120103,6037120103,"Census Tract 1201.03, Los Angeles, CA",848,48,57,24,791,52
14000US06037120104,6037120104,"Census Tract 1201.04, Los Angeles, CA",772,32,93,33,679,47
14000US06037120105,6037120105,"Census Tract 1201.05, Los Angeles, CA",868,34,250,51,618,56
14000US06037120106,6037120106,"Census Tract 1201.06, Los Angeles, CA",1205,52,143,70,1062,89
14000US06037120107,6037120107,"Census Tract 1201.07, Los Angeles, CA",1108,26,66,28,1042,38
14000US06037120108,6037120108,"Census Tract 1201.08, Los Angeles, CA",1356,56,347,71,1009,79
14000US06037120300,6037120300,"Census Tract 1203, Los Angeles, CA",1349,117,964,120,385,108
14000US06037120400,6037120400,"Census Tract 1204, Los Angeles, CA",2057,126,711,143,1346,173
14000US06037121010,6037121010,"Census Tract 1210.10, Los Angeles, CA",1298,45,895,108,403,97
14000US06037121020,6037121020,"Census Tract 1210.20, Los Angeles, CA",1085,50,551,83,534,92
14000US06037121101,6037121101,"Census Tract 1211.01, Los Angeles, CA",927,59,365,57,562,79
14000US06037121102,6037121102,"Census Tract 1211.02, Los Angeles, CA",811,57,497,88,314,80
14000US06037121210,6037121210,"Census Tract 1212.10, Los Angeles, CA",766,50,488,67,278,47
14000US06037121221,6037121221,"Census Tract 1212.21, Los Angeles, CA",517,44,337,39,180,51
14000US06037121222,6037121222,"Census Tract 1212.22, Los Angeles, CA",1218,79,408,89,810,106
14000US06037121600,6037121600,"Census Tract 1216, Los Angeles, CA",856,36,660,80,196,81
14000US06037121801,6037121801,"Census Tract 1218.01, Los Angeles, CA",1143,77,371,91,772,86
14000US06037121802,6037121802,"Census Tract 1218.02, Los Angeles, CA",709,35,476,57,233,58
14000US06037121900,6037121900,"Census Tract 1219, Los Angeles, CA",991,95,551,105,440,126
14000US06037122000,6037122000,"Census Tract 1220, Los Angeles, CA",1568,51,969,124,599,141
14000US06037122120,6037122120,"Census Tract 1221.20, Los Angeles, CA",1086,71,604,109,482,103
14000US06037122121,6037122121,"Census Tract 1221.21, Los Angeles, CA",720,42,336,48,384,50
14000US06037122122,6037122122,"Census Tract 1221.22, Los Angeles, CA",639,42,163,39,476,54
14000US06037122200,6037122200,"Census Tract 1222, Los Angeles, CA",890,53,424,70,466,80
14000US06037122410,6037122410,"Census Tract 1224.10, Los Angeles, CA",1171,58,142,51,1029,70
14000US06037122420,6037122420,"Census Tract 1224.20, Los Angeles, CA",1405,43,483,96,922,108
14000US06037123010,6037123010,"Census Tract 1230.10, Los Angeles, CA",1057,41,402,55,655,72
14000US06037123020,6037123020,"Census Tract 1230.20, Los Angeles, CA",831,36,499,83,332,76
14000US06037123103,6037123103,"Census Tract 1231.03, Los Angeles, CA",1531,81,540,101,991,122
14000US06037123104,6037123104,"Census Tract 1231.04, Los Angeles, CA",1525,89,406,76,1119,107
14000US06037123203,6037123203,"Census Tract 1232.03, Los Angeles, CA",1165,47,178,74,987,84
14000US06037123204,6037123204,"Census Tract 1232.04, Los Angeles, CA",1011,55,143,40,868,59
14000US06037123205,6037123205,"Census Tract 1232.05, Los Angeles, CA",749,49,146,45,603,62
14000US06037123206,6037123206,"Census Tract 1232.06, Los Angeles, CA",846,44,194,45,652,65
14000US06037123301,6037123301,"Census Tract 1233.01, Los Angeles, CA",1548,88,598,97,950,113
14000US06037123303,6037123303,"Census Tract 1233.03, Los Angeles, CA",937,49,265,47,672,65
14000US06037123304,6037123304,"Census Tract 1233.04, Los Angeles, CA",1701,71,333,81,1368,103
14000US06037123410,6037123410,"Census Tract 1234.10, Los Angeles, CA",1262,57,286,107,976,110
14000US06037123420,6037123420,"Census Tract 1234.20, Los Angeles, CA",1450,63,504,90,946,102
14000US06037123510,6037123510,"Census Tract 1235.10, Los Angeles, CA",1660,67,413,84,1247,98
14000US06037123520,6037123520,"Census Tract 1235.20, Los Angeles, CA",854,44,287,42,567,59
14000US06037123601,6037123601,"Census Tract 1236.01, Los Angeles, CA",1885,75,650,107,1235,116
14000US06037123602,6037123602,"Census Tract 1236.02, Los Angeles, CA",1350,49,528,79,822,82
14000US06037123700,6037123700,"Census Tract 1237, Los Angeles, CA",1440,76,784,133,656,128
14000US06037123800,6037123800,"Census Tract 1238, Los Angeles, CA",2396,85,773,156,1623,175
14000US06037123901,6037123901,"Census Tract 1239.01, Los Angeles, CA",1521,61,446,120,1075,123
14000US06037123902,6037123902,"Census Tract 1239.02, Los Angeles, CA",1074,66,381,79,693,95
14000US06037124000,6037124000,"Census Tract 1240, Los Angeles, CA",2117,75,975,184,1142,184
14000US06037124102,6037124102,"Census Tract 1241.02, Los Angeles, CA",1362,94,287,70,1075,106
14000US06037124103,6037124103,"Census Tract 1241.03, Los Angeles, CA",611,30,210,49,401,55
14000US06037124104,6037124104,"Census Tract 1241.04, Los Angeles, CA",996,54,157,49,839,75
14000US06037124105,6037124105,"Census Tract 1241.05, Los Angeles, CA",929,40,161,53,768,55
14000US06037124201,6037124201,"Census Tract 1242.01, Los Angeles, CA",1141,56,531,100,610,97
14000US06037124203,6037124203,"Census Tract 1242.03, Los Angeles, CA",814,48,313,58,501,61
14000US06037124204,6037124204,"Census Tract 1242.04, Los Angeles, CA",929,98,135,62,794,109
14000US06037124300,6037124300,"Census Tract 1243, Los Angeles, CA",1150,119,297,92,853,116
14000US06037124400,6037124400,"Census Tract 1244, Los Angeles, CA",1768,51,642,103,1126,114
14000US06037124500,6037124500,"Census Tract 1245, Los Angeles, CA",1168,83,586,120,582,130
14000US06037124600,6037124600,"Census Tract 1246, Los Angeles, CA",1310,96,510,80,800,115
14000US06037124700,6037124700,"Census Tract 1247, Los Angeles, CA",2474,81,1156,171,1318,181
14000US06037124902,6037124902,"Census Tract 1249.02, Los Angeles, CA",1534,83,161,63,1373,86
14000US06037124903,6037124903,"Census Tract 1249.03, Los Angeles, CA",1508,107,328,101,1180,125
14000US06037125100,6037125100,"Census Tract 1251, Los Angeles, CA",2852,162,686,133,2166,204
14000US06037125200,6037125200,"Census Tract 1252, Los Angeles, CA",1653,108,575,92,1078,137
14000US06037125310,6037125310,"Census Tract 1253.10, Los Angeles, CA",1973,176,369,137,1604,201
14000US06037125320,6037125320,"Census Tract 1253.20, Los Angeles, CA",2753,167,95,57,2658,179
14000US06037125401,6037125401,"Census Tract 1254.01, Los Angeles, CA",2558,179,125,60,2433,185
14000US06037125402,6037125402,"Census Tract 1254.02, Los Angeles, CA",2040,97,624,139,1416,145
14000US06037125501,6037125501,"Census Tract 1255.01, Los Angeles, CA",1627,93,161,48,1466,98
14000US06037125502,6037125502,"Census Tract 1255.02, Los Angeles, CA",1843,97,442,111,1401,135
14000US06037125600,6037125600,"Census Tract 1256, Los Angeles, CA",1185,81,600,105,585,119
14000US06037127102,6037127102,"Census Tract 1271.02, Los Angeles, CA",1666,56,602,127,1064,134
14000US06037127103,6037127103,"Census Tract 1271.03, Los Angeles, CA",1099,79,190,77,909,100
14000US06037127104,6037127104,"Census Tract 1271.04, Los Angeles, CA",1298,53,422,105,876,104
14000US06037127210,6037127210,"Census Tract 1272.10, Los Angeles, CA",1905,107,598,116,1307,137
14000US06037127220,6037127220,"Census Tract 1272.20, Los Angeles, CA",1733,61,528,137,1205,125
14000US06037127300,6037127300,"Census Tract 1273, Los Angeles, CA",1375,68,496,91,879,112
14000US06037127400,6037127400,"Census Tract 1274, Los Angeles, CA",1865,72,477,115,1388,121
14000US06037127520,6037127520,"Census Tract 1275.20, Los Angeles, CA",1499,33,92,42,1407,50
14000US06037127603,6037127603,"Census Tract 1276.03, Los Angeles, CA",937,30,140,47,797,50
14000US06037127604,6037127604,"Census Tract 1276.04, Los Angeles, CA",1203,84,200,58,1003,91
14000US06037127605,6037127605,"Census Tract 1276.05, Los Angeles, CA",1170,51,126,54,1044,70
14000US06037127606,6037127606,"Census Tract 1276.06, Los Angeles, CA",1150,43,378,76,772,87
14000US06037127711,6037127711,"Census Tract 1277.11, Los Angeles, CA",1188,61,438,73,750,94
14000US06037127712,6037127712,"Census Tract 1277.12, Los Angeles, CA",1580,59,234,75,1346,92
14000US06037127803,6037127803,"Census Tract 1278.03, Los Angeles, CA",1670,65,353,100,1317,99
14000US06037127804,6037127804,"Census Tract 1278.04, Los Angeles, CA",1646,35,475,90,1171,96
14000US06037127805,6037127805,"Census Tract 1278.05, Los Angeles, CA",1198,67,278,70,920,80
14000US06037127806,6037127806,"Census Tract 1278.06, Los Angeles, CA",1198,92,260,83,938,100
14000US06037127910,6037127910,"Census Tract 1279.10, Los Angeles, CA",1446,109,285,91,1161,108
14000US06037127920,6037127920,"Census Tract 1279.20, Los Angeles, CA",1345,56,470,102,875,120
14000US06037128101,6037128101,"Census Tract 1281.01, Los Angeles, CA",1271,50,422,86,849,84
14000US06037128102,6037128102,"Census Tract 1281.02, Los Angeles, CA",1485,72,247,74,1238,100
14000US06037128210,6037128210,"Census Tract 1282.10, Los Angeles, CA",1555,81,46,37,1509,84
14000US06037128220,6037128220,"Census Tract 1282.20, Los Angeles, CA",1204,53,419,76,785,86
14000US06037128302,6037128302,"Census Tract 1283.02, Los Angeles, CA",1498,65,186,65,1312,88
14000US06037128303,6037128303,"Census Tract 1283.03, Los Angeles, CA",1160,60,35,36,1125,69
14000US06037128400,6037128400,"Census Tract 1284, Los Angeles, CA",1724,60,894,105,830,125
14000US06037128500,6037128500,"Census Tract 1285, Los Angeles, CA",1992,92,697,86,1295,121
14000US06037128601,6037128601,"Census Tract 1286.01, Los Angeles, CA",1628,109,365,87,1263,137
14000US06037128602,6037128602,"Census Tract 1286.02, Los Angeles, CA",1398,70,724,95,674,85
14000US06037128702,6037128702,"Census Tract 1287.02, Los Angeles, CA",2731,170,981,160,1750,187
14000US06037128801,6037128801,"Census Tract 1288.01, Los Angeles, CA",1818,113,501,98,1317,126
14000US06037128802,6037128802,"Census Tract 1288.02, Los Angeles, CA",2022,148,702,121,1320,181
14000US06037128910,6037128910,"Census Tract 1289.10, Los Angeles, CA",1954,77,884,128,1070,127
14000US06037131010,6037131010,"Census Tract 1310.10, Los Angeles, CA",1999,85,422,103,1577,109
14000US06037131020,6037131020,"Census Tract 1310.20, Los Angeles, CA",1697,56,879,120,818,112
14000US06037131100,6037131100,"Census Tract 1311, Los Angeles, CA",1040,46,961,64,79,52
14000US06037131200,6037131200,"Census Tract 1312, Los Angeles, CA",1212,60,879,85,333,88
14000US06037131300,6037131300,"Census Tract 1313, Los Angeles, CA",1216,58,870,103,346,88
14000US06037131400,6037131400,"Census Tract 1314, Los Angeles, CA",1935,72,892,104,1043,105
14000US06037131600,6037131600,"Census Tract 1316, Los Angeles, CA",1450,86,1045,141,405,123
14000US06037131701,6037131701,"Census Tract 1317.01, Los Angeles, CA",1828,45,807,111,1021,110
14000US06037131702,6037131702,"Census Tract 1317.02, Los Angeles, CA",1123,72,786,109,337,87
14000US06037131800,6037131800,"Census Tract 1318, Los Angeles, CA",1638,102,614,98,1024,133
14000US06037131900,6037131900,"Census Tract 1319, Los Angeles, CA",1386,69,1063,128,323,116
14000US06037132001,6037132001,"Census Tract 1320.01, Los Angeles, CA",1162,79,726,85,436,85
14000US06037132002,6037132002,"Census Tract 1320.02, Los Angeles, CA",1112,49,658,100,454,101
14000US06037132101,6037132101,"Census Tract 1321.01, Los Angeles, CA",1579,95,595,108,984,131
14000US06037132102,6037132102,"Census Tract 1321.02, Los Angeles, CA",2157,118,931,186,1226,183
14000US06037132300,6037132300,"Census Tract 1323, Los Angeles, CA",2506,56,696,161,1810,173
14000US06037132501,6037132501,"Census Tract 1325.01, Los Angeles, CA",1193,68,541,102,652,108
14000US06037132502,6037132502,"Census Tract 1325.02, Los Angeles, CA",1365,30,710,117,655,115
14000US06037132700,6037132700,"Census Tract 1327, Los Angeles, CA",1592,58,857,114,735,106
14000US06037132900,6037132900,"Census Tract 1329, Los Angeles, CA",1343,44,775,82,568,79
14000US06037133000,6037133000,"Census Tract 1330, Los Angeles, CA",1314,21,895,123,419,122
14000US06037133100,6037133100,"Census Tract 1331, Los Angeles, CA",2024,92,846,108,1178,115
14000US06037134001,6037134001,"Census Tract 1340.01, Los Angeles, CA",982,37,325,65,657,72
14000US06037134002,6037134002,"Census Tract 1340.02, Los Angeles, CA",1084,53,490,58,594,76
14000US06037134101,6037134101,"Census Tract 1341.01, Los Angeles, CA",1450,82,890,148,560,133
14000US06037134103,6037134103,"Census Tract 1341.03, Los Angeles, CA",1346,55,826,90,520,86
14000US06037134104,6037134104,"Census Tract 1341.04, Los Angeles, CA",1440,33,595,78,845,83
14000US06037134201,6037134201,"Census Tract 1342.01, Los Angeles, CA",1253,70,979,106,274,101
14000US06037134302,6037134302,"Census Tract 1343.02, Los Angeles, CA",1261,38,1028,89,233,85
14000US06037134303,6037134303,"Census Tract 1343.03, Los Angeles, CA",1824,62,1356,117,468,103
14000US06037134304,6037134304,"Census Tract 1343.04, Los Angeles, CA",926,41,615,68,311,71
14000US06037134305,6037134305,"Census Tract 1343.05, Los Angeles, CA",1130,38,5,9,1125,39
14000US06037134306,6037134306,"Census Tract 1343.06, Los Angeles, CA",1324,22,384,83,940,88
14000US06037134421,6037134421,"Census Tract 1344.21, Los Angeles, CA",1386,53,1298,68,88,43
14000US06037134422,6037134422,"Census Tract 1344.22, Los Angeles, CA",1590,86,1362,131,228,97
14000US06037134423,6037134423,"Census Tract 1344.23, Los Angeles, CA",1297,28,1057,91,240,86
14000US06037134424,6037134424,"Census Tract 1344.24, Los Angeles, CA",967,32,939,41,28,20
14000US06037134520,6037134520,"Census Tract 1345.20, Los Angeles, CA",1879,81,288,72,1591,111
14000US06037134521,6037134521,"Census Tract 1345.21, Los Angeles, CA",791,23,148,41,643,47
14000US06037134522,6037134522,"Census Tract 1345.22, Los Angeles, CA",1399,32,269,64,1130,67
14000US06037134710,6037134710,"Census Tract 1347.10, Los Angeles, CA",1645,46,340,79,1305,93
14000US06037134720,6037134720,"Census Tract 1347.20, Los Angeles, CA",1657,55,837,134,820,139
14000US06037134800,6037134800,"Census Tract 1348, Los Angeles, CA",1884,74,1316,135,568,135
14000US06037134901,6037134901,"Census Tract 1349.01, Los Angeles, CA",1121,77,681,87,440,108
14000US06037134903,6037134903,"Census Tract 1349.03, Los Angeles, CA",2764,173,0,17,2764,173
14000US06037134904,6037134904,"Census Tract 1349.04, Los Angeles, CA",1369,87,638,91,731,121
14000US06037134905,6037134905,"Census Tract 1349.05, Los Angeles, CA",2434,124,377,103,2057,147
14000US06037135102,6037135102,"Census Tract 1351.02, Los Angeles, CA",1210,66,982,111,228,91
14000US06037135111,6037135111,"Census Tract 1351.11, Los Angeles, CA",1134,70,610,94,524,99
14000US06037135113,6037135113,"Census Tract 1351.13, Los Angeles, CA",1405,100,218,67,1187,109
14000US06037135114,6037135114,"Census Tract 1351.14, Los Angeles, CA",2746,130,397,122,2349,166
14000US06037135201,6037135201,"Census Tract 1352.01, Los Angeles, CA",897,43,714,63,183,59
14000US06037135202,6037135202,"Census Tract 1352.02, Los Angeles, CA",1483,47,1228,98,255,97
14000US06037135203,6037135203,"Census Tract 1352.03, Los Angeles, CA",2545,21,2186,151,359,154
14000US06037137000,6037137000,"Census Tract 1370, Los Angeles, CA",1722,56,1380,115,342,114
14000US06037137103,6037137103,"Census Tract 1371.03, Los Angeles, CA",2395,112,1274,216,1121,229
14000US06037137104,6037137104,"Census Tract 1371.04, Los Angeles, CA",1012,76,821,91,191,80
14000US06037137201,6037137201,"Census Tract 1372.01, Los Angeles, CA",2284,139,1069,195,1215,207
14000US06037137301,6037137301,"Census Tract 1373.01, Los Angeles, CA",765,54,708,56,57,37
14000US06037137302,6037137302,"Census Tract 1373.02, Los Angeles, CA",1602,52,1475,76,127,58
14000US06037137401,6037137401,"Census Tract 1374.01, Los Angeles, CA",1612,89,1109,110,503,112
14000US06037137402,6037137402,"Census Tract 1374.02, Los Angeles, CA",2073,112,1555,126,518,137
14000US06037137501,6037137501,"Census Tract 1375.01, Los Angeles, CA",1932,127,755,95,1177,152
14000US06037137502,6037137502,"Census Tract 1375.02, Los Angeles, CA",1813,110,1178,127,635,142
14000US06037137504,6037137504,"Census Tract 1375.04, Los Angeles, CA",699,33,662,39,37,26
14000US06037138000,6037138000,"Census Tract 1380, Los Angeles, CA",1799,93,1472,110,327,111
14000US06037139001,6037139001,"Census Tract 1390.01, Los Angeles, CA",2235,27,1130,184,1105,188
14000US06037139200,6037139200,"Census Tract 1392, Los Angeles, CA",2098,156,1166,154,932,197
14000US06037139301,6037139301,"Census Tract 1393.01, Los Angeles, CA",1579,130,1289,163,290,135
14000US06037139302,6037139302,"Census Tract 1393.02, Los Angeles, CA",1976,119,343,100,1633,151
14000US06037139303,6037139303,"Census Tract 1393.03, Los Angeles, CA",1972,83,680,105,1292,124
14000US06037139401,6037139401,"Census Tract 1394.01, Los Angeles, CA",1313,70,301,91,1012,99
14000US06037139402,6037139402,"Census Tract 1394.02, Los Angeles, CA",959,39,806,70,153,75
14000US06037139502,6037139502,"Census Tract 1395.02, Los Angeles, CA",1090,115,687,102,403,96
14000US06037139503,6037139503,"Census Tract 1395.03, Los Angeles, CA",2749,85,995,196,1754,203
14000US06037139504,6037139504,"Census Tract 1395.04, Los Angeles, CA",1801,94,441,92,1360,134
14000US06037139600,6037139600,"Census Tract 1396, Los Angeles, CA",2202,138,1329,199,873,203
14000US06037139701,6037139701,"Census Tract 1397.01, Los Angeles, CA",1948,145,1451,163,497,181
14000US06037139702,6037139702,"Census Tract 1397.02, Los Angeles, CA",2229,86,2053,138,176,111
14000US06037139703,6037139703,"Census Tract 1397.03, Los Angeles, CA",965,52,798,76,167,57
14000US06037139801,6037139801,"Census Tract 1398.01, Los Angeles, CA",1291,58,1198,79,93,71
14000US06037139802,6037139802,"Census Tract 1398.02, Los Angeles, CA",1393,51,1300,92,93,75
14000US06037141101,6037141101,"Census Tract 1411.01, Los Angeles, CA",2166,178,560,167,1606,192
14000US06037141102,6037141102,"Census Tract 1411.02, Los Angeles, CA",1357,89,526,99,831,114
14000US06037141201,6037141201,"Census Tract 1412.01, Los Angeles, CA",2123,62,275,79,1848,93
14000US06037141202,6037141202,"Census Tract 1412.02, Los Angeles, CA",1398,102,565,102,833,116
14000US06037141302,6037141302,"Census Tract 1413.02, Los Angeles, CA",2978,173,781,166,2197,198
14000US06037141303,6037141303,"Census Tract 1413.03, Los Angeles, CA",1779,54,432,85,1347,83
14000US06037141304,6037141304,"Census Tract 1413.04, Los Angeles, CA",1419,89,622,112,797,106
14000US06037141400,6037141400,"Census Tract 1414, Los Angeles, CA",2016,91,983,104,1033,134
14000US06037141500,6037141500,"Census Tract 1415, Los Angeles, CA",1087,82,1069,85,18,20
14000US06037141600,6037141600,"Census Tract 1416, Los Angeles, CA",1611,84,1443,121,168,100
14000US06037141700,6037141700,"Census Tract 1417, Los Angeles, CA",1221,94,1136,100,85,38
14000US06037143100,6037143100,"Census Tract 1431, Los Angeles, CA",2248,131,807,157,1441,170
14000US06037143200,6037143200,"Census Tract 1432, Los Angeles, CA",2068,152,577,118,1491,179
14000US06037143300,6037143300,"Census Tract 1433, Los Angeles, CA",3165,145,1180,190,1985,208
14000US06037143400,6037143400,"Census Tract 1434, Los Angeles, CA",3036,164,1421,201,1615,200
14000US06037143500,6037143500,"Census Tract 1435, Los Angeles, CA",2297,155,978,148,1319,190
14000US06037143602,6037143602,"Census Tract 1436.02, Los Angeles, CA",2182,130,1235,173,947,161
14000US06037143603,6037143603,"Census Tract 1436.03, Los Angeles, CA",1354,75,395,53,959,93
14000US06037143604,6037143604,"Census Tract 1436.04, Los Angeles, CA",2087,144,101,53,1986,150
14000US06037143700,6037143700,"Census Tract 1437, Los Angeles, CA",1825,115,1365,105,460,97
14000US06037143800,6037143800,"Census Tract 1438, Los Angeles, CA",2395,131,1307,149,1088,148
14000US06037143901,6037143901,"Census Tract 1439.01, Los Angeles, CA",1506,98,1346,117,160,85
14000US06037143902,6037143902,"Census Tract 1439.02, Los Angeles, CA",1295,101,717,102,578,85
14000US06037181000,6037181000,"Census Tract 1810, Los Angeles, CA",2183,133,1541,146,642,145
14000US06037181300,6037181300,"Census Tract 1813, Los Angeles, CA",1327,80,869,110,458,91
14000US06037181400,6037181400,"Census Tract 1814, Los Angeles, CA",1645,116,507,105,1138,129
14000US06037181500,6037181500,"Census Tract 1815, Los Angeles, CA",1428,56,1035,118,393,113
14000US06037181600,6037181600,"Census Tract 1816, Los Angeles, CA",1029,74,458,89,571,102
14000US06037183101,6037183101,"Census Tract 1831.01, Los Angeles, CA",1343,75,693,109,650,124
14000US06037183103,6037183103,"Census Tract 1831.03, Los Angeles, CA",1503,36,280,70,1223,77
14000US06037183104,6037183104,"Census Tract 1831.04, Los Angeles, CA",767,34,521,53,246,52
14000US06037183220,6037183220,"Census Tract 1832.20, Los Angeles, CA",1205,56,543,115,662,111
14000US06037183221,6037183221,"Census Tract 1832.21, Los Angeles, CA",1083,50,455,89,628,95
14000US06037183222,6037183222,"Census Tract 1832.22, Los Angeles, CA",1339,76,808,97,531,94
14000US06037183300,6037183300,"Census Tract 1833, Los Angeles, CA",1020,52,492,80,528,88
14000US06037183401,6037183401,"Census Tract 1834.01, Los Angeles, CA",844,41,446,61,398,65
14000US06037183402,6037183402,"Census Tract 1834.02, Los Angeles, CA",955,48,268,68,687,76
14000US06037183510,6037183510,"Census Tract 1835.10, Los Angeles, CA",783,46,593,59,190,53
14000US06037183520,6037183520,"Census Tract 1835.20, Los Angeles, CA",1137,55,328,66,809,88
14000US06037183610,6037183610,"Census Tract 1836.10, Los Angeles, CA",994,43,327,45,667,62
14000US06037183620,6037183620,"Census Tract 1836.20, Los Angeles, CA",994,55,468,85,526,86
14000US06037183701,6037183701,"Census Tract 1837.01, Los Angeles, CA",1338,64,501,91,837,110
14000US06037183702,6037183702,"Census Tract 1837.02, Los Angeles, CA",1054,95,462,103,592,109
14000US06037183810,6037183810,"Census Tract 1838.10, Los Angeles, CA",1302,75,177,67,1125,91
14000US06037183820,6037183820,"Census Tract 1838.20, Los Angeles, CA",1140,33,257,83,883,89
14000US06037185100,6037185100,"Census Tract 1851, Los Angeles, CA",2233,123,1367,163,866,176
14000US06037185202,6037185202,"Census Tract 1852.02, Los Angeles, CA",1360,90,685,116,675,116
14000US06037185203,6037185203,"Census Tract 1852.03, Los Angeles, CA",989,64,366,71,623,88
14000US06037185204,6037185204,"Census Tract 1852.04, Los Angeles, CA",701,44,528,54,173,50
14000US06037185310,6037185310,"Census Tract 1853.10, Los Angeles, CA",856,41,319,54,537,59
14000US06037185320,6037185320,"Census Tract 1853.20, Los Angeles, CA",855,48,297,51,558,62
14000US06037186100,6037186100,"Census Tract 1861, Los Angeles, CA",1853,74,1207,107,646,120
14000US06037186201,6037186201,"Census Tract 1862.01, Los Angeles, CA",1177,94,263,93,914,137
14000US06037186202,6037186202,"Census Tract 1862.02, Los Angeles, CA",711,57,380,61,331,67
14000US06037186203,6037186203,"Census Tract 1862.03, Los Angeles, CA",1116,52,925,88,191,88
14000US06037186301,6037186301,"Census Tract 1863.01, Los Angeles, CA",889,53,247,57,642,70
14000US06037186302,6037186302,"Census Tract 1863.02, Los Angeles, CA",1849,105,1067,147,782,135
14000US06037186401,6037186401,"Census Tract 1864.01, Los Angeles, CA",1001,44,122,48,879,62
14000US06037186403,6037186403,"Census Tract 1864.03, Los Angeles, CA",835,43,377,53,458,55
14000US06037186404,6037186404,"Census Tract 1864.04, Los Angeles, CA",772,37,248,63,524,62
14000US06037187101,6037187101,"Census Tract 1871.01, Los Angeles, CA",1228,77,559,124,669,134
14000US06037187102,6037187102,"Census Tract 1871.02, Los Angeles, CA",1379,53,516,106,863,120
14000US06037187200,6037187200,"Census Tract 1872, Los Angeles, CA",933,57,372,53,561,58
14000US06037187300,6037187300,"Census Tract 1873, Los Angeles, CA",1515,80,676,108,839,127
14000US06037188100,6037188100,"Census Tract 1881, Los Angeles, CA",1720,97,477,98,1243,119
14000US06037188201,6037188201,"Census Tract 1882.01, Los Angeles, CA",1811,96,251,77,1560,104
14000US06037188202,6037188202,"Census Tract 1882.02, Los Angeles, CA",1171,68,623,69,548,75
14000US06037188300,6037188300,"Census Tract 1883, Los Angeles, CA",1390,92,698,120,692,110
14000US06037189101,6037189101,"Census Tract 1891.01, Los Angeles, CA",1316,110,243,83,1073,134
14000US06037189102,6037189102,"Census Tract 1891.02, Los Angeles, CA",1934,80,402,73,1532,106
14000US06037189201,6037189201,"Census Tract 1892.01, Los Angeles, CA",1943,94,118,50,1825,105
14000US06037189202,6037189202,"Census Tract 1892.02, Los Angeles, CA",1153,96,582,85,571,100
14000US06037189300,6037189300,"Census Tract 1893, Los Angeles, CA",1315,89,1168,99,147,54
14000US06037189400,6037189400,"Census Tract 1894, Los Angeles, CA",1628,140,976,119,652,129
14000US06037189500,6037189500,"Census Tract 1895, Los Angeles, CA",2666,169,416,121,2250,187
14000US06037189600,6037189600,"Census Tract 1896, Los Angeles, CA",1999,139,666,99,1333,145
14000US06037189701,6037189701,"Census Tract 1897.01, Los Angeles, CA",1743,213,1032,155,711,150
14000US06037189702,6037189702,"Census Tract 1897.02, Los Angeles, CA",1301,135,728,106,573,140
14000US06037189800,6037189800,"Census Tract 1898, Los Angeles, CA",2286,199,538,165,1748,225
14000US06037189902,6037189902,"Census Tract 1899.02, Los Angeles, CA",3048,155,135,83,2913,181
14000US06037189903,6037189903,"Census Tract 1899.03, Los Angeles, CA",1513,86,446,110,1067,116
14000US06037189904,6037189904,"Census Tract 1899.04, Los Angeles, CA",1505,120,27,25,1478,121
14000US06037189905,6037189905,"Census Tract 1899.05, Los Angeles, CA",1465,75,318,82,1147,101
14000US06037190100,6037190100,"Census Tract 1901, Los Angeles, CA",2654,229,59,51,2595,239
14000US06037190201,6037190201,"Census Tract 1902.01, Los Angeles, CA",1279,128,15,17,1264,131
14000US06037190202,6037190202,"Census Tract 1902.02, Los Angeles, CA",2307,202,24,35,2283,199
14000US06037190301,6037190301,"Census Tract 1903.01, Los Angeles, CA",2803,187,175,77,2628,199
14000US06037190401,6037190401,"Census Tract 1904.01, Los Angeles, CA",1756,93,23,18,1733,95
14000US06037190402,6037190402,"Census Tract 1904.02, Los Angeles, CA",1366,69,11,17,1355,72
14000US06037190510,6037190510,"Census Tract 1905.10, Los Angeles, CA",1712,127,0,12,1712,127
14000US06037190520,6037190520,"Census Tract 1905.20, Los Angeles, CA",1604,84,117,61,1487,106
14000US06037190700,6037190700,"Census Tract 1907, Los Angeles, CA",1705,155,224,103,1481,174
14000US06037190801,6037190801,"Census Tract 1908.01, Los Angeles, CA",1273,108,78,32,1195,111
14000US06037190802,6037190802,"Census Tract 1908.02, Los Angeles, CA",1370,99,157,68,1213,115
14000US06037190901,6037190901,"Census Tract 1909.01, Los Angeles, CA",1414,118,101,60,1313,130
14000US06037190902,6037190902,"Census Tract 1909.02, Los Angeles, CA",1518,85,83,46,1435,87
14000US06037191000,6037191000,"Census Tract 1910, Los Angeles, CA",2389,247,132,84,2257,246
14000US06037191110,6037191110,"Census Tract 1911.10, Los Angeles, CA",1032,92,40,25,992,89
14000US06037191120,6037191120,"Census Tract 1911.20, Los Angeles, CA",1571,88,160,71,1411,110
14000US06037191201,6037191201,"Census Tract 1912.01, Los Angeles, CA",1629,77,109,50,1520,87
14000US06037191203,6037191203,"Census Tract 1912.03, Los Angeles, CA",1166,77,53,40,1113,87
14000US06037191204,6037191204,"Census Tract 1912.04, Los Angeles, CA",860,43,68,31,792,48
14000US06037191301,6037191301,"Census Tract 1913.01, Los Angeles, CA",940,52,108,51,832,69
14000US06037191302,6037191302,"Census Tract 1913.02, Los Angeles, CA",862,67,89,39,773,71
14000US06037191410,6037191410,"Census Tract 1914.10, Los Angeles, CA",1627,91,72,37,1555,96
14000US06037191420,6037191420,"Census Tract 1914.20, Los Angeles, CA",1184,62,54,37,1130,69
14000US06037191500,6037191500,"Census Tract 1915, Los Angeles, CA",1789,86,403,74,1386,99
14000US06037191610,6037191610,"Census Tract 1916.10, Los Angeles, CA",1433,94,140,47,1293,100
14000US06037191620,6037191620,"Census Tract 1916.20, Los Angeles, CA",1077,82,82,59,995,91
14000US06037191710,6037191710,"Census Tract 1917.10, Los Angeles, CA",1244,75,74,49,1170,86
14000US06037191720,6037191720,"Census Tract 1917.20, Los Angeles, CA",1197,104,92,59,1105,117
14000US06037191810,6037191810,"Census Tract 1918.10, Los Angeles, CA",1259,116,57,36,1202,121
14000US06037191820,6037191820,"Census Tract 1918.20, Los Angeles, CA",1449,103,121,61,1328,116
14000US06037191901,6037191901,"Census Tract 1919.01, Los Angeles, CA",1740,129,84,51,1656,126
14000US06037191902,6037191902,"Census Tract 1919.02, Los Angeles, CA",1411,140,652,131,759,119
14000US06037192001,6037192001,"Census Tract 1920.01, Los Angeles, CA",1149,108,222,63,927,107
14000US06037192002,6037192002,"Census Tract 1920.02, Los Angeles, CA",1244,109,584,87,660,110
14000US06037192300,6037192300,"Census Tract 1923, Los Angeles, CA",1375,121,500,76,875,113
14000US06037192410,6037192410,"Census Tract 1924.10, Los Angeles, CA",1719,117,635,101,1084,135
14000US06037192420,6037192420,"Census Tract 1924.20, Los Angeles, CA",1393,104,148,59,1245,121
14000US06037192510,6037192510,"Census Tract 1925.10, Los Angeles, CA",1241,79,283,98,958,100
14000US06037192520,6037192520,"Census Tract 1925.20, Los Angeles, CA",1558,87,62,37,1496,94
14000US06037192610,6037192610,"Census Tract 1926.10, Los Angeles, CA",1326,108,84,61,1242,103
14000US06037192620,6037192620,"Census Tract 1926.20, Los Angeles, CA",1137,88,41,43,1096,90
14000US06037192700,6037192700,"Census Tract 1927, Los Angeles, CA",1027,111,126,52,901,113
14000US06037194101,6037194101,"Census Tract 1941.01, Los Angeles, CA",1631,141,580,106,1051,152
14000US06037194102,6037194102,"Census Tract 1941.02, Los Angeles, CA",1531,123,1190,136,341,116
14000US06037194200,6037194200,"Census Tract 1942, Los Angeles, CA",1463,148,1149,147,314,103
14000US06037194300,6037194300,"Census Tract 1943, Los Angeles, CA",1451,112,1055,114,396,121
14000US06037194401,6037194401,"Census Tract 1944.01, Los Angeles, CA",1234,114,247,76,987,114
14000US06037194402,6037194402,"Census Tract 1944.02, Los Angeles, CA",2028,165,642,156,1386,177
14000US06037194500,6037194500,"Census Tract 1945, Los Angeles, CA",944,60,476,71,468,70
14000US06037195100,6037195100,"Census Tract 1951, Los Angeles, CA",2065,160,1290,182,775,149
14000US06037195201,6037195201,"Census Tract 1952.01, Los Angeles, CA",1645,72,283,67,1362,88
14000US06037195202,6037195202,"Census Tract 1952.02, Los Angeles, CA",1411,98,742,87,669,116
14000US06037195300,6037195300,"Census Tract 1953, Los Angeles, CA",1419,100,308,81,1111,105
14000US06037195400,6037195400,"Census Tract 1954, Los Angeles, CA",2229,134,782,107,1447,151
14000US06037195500,6037195500,"Census Tract 1955, Los Angeles, CA",2400,122,1141,186,1259,208
14000US06037195600,6037195600,"Census Tract 1956, Los Angeles, CA",1256,68,375,79,881,87
14000US06037195710,6037195710,"Census Tract 1957.10, Los Angeles, CA",1367,62,234,72,1133,93
14000US06037195720,6037195720,"Census Tract 1957.20, Los Angeles, CA",858,63,196,48,662,68
14000US06037195802,6037195802,"Census Tract 1958.02, Los Angeles, CA",938,59,222,63,716,74
14000US06037195803,6037195803,"Census Tract 1958.03, Los Angeles, CA",1156,76,316,76,840,90
14000US06037195804,6037195804,"Census Tract 1958.04, Los Angeles, CA",1011,81,282,74,729,108
14000US06037195901,6037195901,"Census Tract 1959.01, Los Angeles, CA",1064,76,168,62,896,96
14000US06037195902,6037195902,"Census Tract 1959.02, Los Angeles, CA",1005,75,198,60,807,77
14000US06037195903,6037195903,"Census Tract 1959.03, Los Angeles, CA",911,57,158,54,753,62
14000US06037197200,6037197200,"Census Tract 1972, Los Angeles, CA",1191,60,606,130,585,137
14000US06037197300,6037197300,"Census Tract 1973, Los Angeles, CA",1786,70,428,94,1358,121
14000US06037197410,6037197410,"Census Tract 1974.10, Los Angeles, CA",1722,85,901,122,821,121
14000US06037197420,6037197420,"Census Tract 1974.20, Los Angeles, CA",1347,97,438,98,909,112
14000US06037197500,6037197500,"Census Tract 1975, Los Angeles, CA",1567,100,360,102,1207,141
14000US06037197600,6037197600,"Census Tract 1976, Los Angeles, CA",910,69,186,49,724,80
14000US06037197700,6037197700,"Census Tract 1977, Los Angeles, CA",2043,70,299,98,1744,117
14000US06037199000,6037199000,"Census Tract 1990, Los Angeles, CA",1640,105,400,100,1240,135
14000US06037199110,6037199110,"Census Tract 1991.10, Los Angeles, CA",737,44,460,65,277,57
14000US06037199120,6037199120,"Census Tract 1991.20, Los Angeles, CA",1115,46,232,61,883,72
14000US06037199201,6037199201,"Census Tract 1992.01, Los Angeles, CA",1089,89,124,58,965,109
14000US06037199202,6037199202,"Census Tract 1992.02, Los Angeles, CA",923,47,424,67,499,75
14000US06037199300,6037199300,"Census Tract 1993, Los Angeles, CA",1315,62,774,94,541,97
14000US06037199400,6037199400,"Census Tract 1994, Los Angeles, CA",1365,53,393,83,972,96
14000US06037199700,6037199700,"Census Tract 1997, Los Angeles, CA",1131,70,276,81,855,91
14000US06037199800,6037199800,"Census Tract 1998, Los Angeles, CA",1563,78,495,106,1068,117
14000US06037199900,6037199900,"Census Tract 1999, Los Angeles, CA",778,53,144,46,634,70
14000US06037201110,6037201110,"Census Tract 2011.10, Los Angeles, CA",704,54,461,54,243,60
14000US06037201120,6037201120,"Census Tract 2011.20, Los Angeles, CA",1288,94,448,91,840,126
14000US06037201200,6037201200,"Census Tract 2012, Los Angeles, CA",757,37,337,55,420,65
14000US06037201301,6037201301,"Census Tract 2013.01, Los Angeles, CA",1109,36,552,71,557,77
14000US06037201302,6037201302,"Census Tract 2013.02, Los Angeles, CA",1885,81,1188,134,697,134
14000US06037201401,6037201401,"Census Tract 2014.01, Los Angeles, CA",1374,72,644,91,730,109
14000US06037201402,6037201402,"Census Tract 2014.02, Los Angeles, CA",1450,36,980,111,470,111
14000US06037201501,6037201501,"Census Tract 2015.01, Los Angeles, CA",1514,85,625,106,889,115
14000US06037201503,6037201503,"Census Tract 2015.03, Los Angeles, CA",965,42,282,60,683,70
14000US06037201504,6037201504,"Census Tract 2015.04, Los Angeles, CA",631,44,345,59,286,65
14000US06037201601,6037201601,"Census Tract 2016.01, Los Angeles, CA",713,31,399,72,314,76
14000US06037201602,6037201602,"Census Tract 2016.02, Los Angeles, CA",828,44,465,64,363,74
14000US06037201700,6037201700,"Census Tract 2017, Los Angeles, CA",1366,88,741,108,625,109
14000US06037203100,6037203100,"Census Tract 2031, Los Angeles, CA",1239,65,168,68,1071,87
14000US06037203200,6037203200,"Census Tract 2032, Los Angeles, CA",1321,53,463,90,858,103
14000US06037203300,6037203300,"Census Tract 2033, Los Angeles, CA",405,52,47,24,358,59
14000US06037203500,6037203500,"Census Tract 2035, Los Angeles, CA",936,66,210,55,726,70
14000US06037203600,6037203600,"Census Tract 2036, Los Angeles, CA",1391,82,335,93,1056,121
14000US06037203710,6037203710,"Census Tract 2037.10, Los Angeles, CA",799,53,191,55,608,76
14000US06037203720,6037203720,"Census Tract 2037.20, Los Angeles, CA",1054,64,195,76,859,102
14000US06037203800,6037203800,"Census Tract 2038, Los Angeles, CA",1143,83,585,102,558,125
14000US06037203900,6037203900,"Census Tract 2039, Los Angeles, CA",718,36,289,55,429,55
14000US06037204110,6037204110,"Census Tract 2041.10, Los Angeles, CA",801,57,303,67,498,84
14000US06037204120,6037204120,"Census Tract 2041.20, Los Angeles, CA",753,14,241,62,512,61
14000US06037204200,6037204200,"Census Tract 2042, Los Angeles, CA",962,50,143,53,819,72
14000US06037204300,6037204300,"Census Tract 2043, Los Angeles, CA",1302,66,391,99,911,95
14000US06037204410,6037204410,"Census Tract 2044.10, Los Angeles, CA",627,43,99,42,528,54
14000US06037204420,6037204420,"Census Tract 2044.20, Los Angeles, CA",944,54,82,39,862,64
14000US06037204600,6037204600,"Census Tract 2046, Los Angeles, CA",1208,55,246,81,962,78
14000US06037204700,6037204700,"Census Tract 2047, Los Angeles, CA",1267,74,663,130,604,125
14000US06037204810,6037204810,"Census Tract 2048.10, Los Angeles, CA",1245,61,415,90,830,103
14000US06037204820,6037204820,"Census Tract 2048.20, Los Angeles, CA",512,41,218,49,294,61
14000US06037204910,6037204910,"Census Tract 2049.10, Los Angeles, CA",944,29,220,59,724,63
14000US06037204920,6037204920,"Census Tract 2049.20, Los Angeles, CA",673,36,287,69,386,69
14000US06037205110,6037205110,"Census Tract 2051.10, Los Angeles, CA",857,37,0,12,857,37
14000US06037205120,6037205120,"Census Tract 2051.20, Los Angeles, CA",977,26,109,35,868,42
14000US06037206010,6037206010,"Census Tract 2060.10, Los Angeles, CA",1258,41,86,48,1172,62
14000US06037206020,6037206020,"Census Tract 2060.20, Los Angeles, CA",297,45,0,17,297,45
14000US06037206031,6037206031,"Census Tract 2060.31, Los Angeles, CA",2469,204,627,147,1842,222
14000US06037206032,6037206032,"Census Tract 2060.32, Los Angeles, CA",1768,78,225,61,1543,105
14000US06037206050,6037206050,"Census Tract 2060.50, Los Angeles, CA",805,45,49,27,756,51
14000US06037206200,6037206200,"Census Tract 2062, Los Angeles, CA",2407,149,269,85,2138,144
14000US06037206300,6037206300,"Census Tract 2063, Los Angeles, CA",2433,215,21,35,2412,221
14000US06037207101,6037207101,"Census Tract 2071.01, Los Angeles, CA",1758,81,62,36,1696,80
14000US06037207102,6037207102,"Census Tract 2071.02, Los Angeles, CA",1329,62,36,24,1293,67
14000US06037207103,6037207103,"Census Tract 2071.03, Los Angeles, CA",961,36,40,23,921,40
14000US06037207301,6037207301,"Census Tract 2073.01, Los Angeles, CA",3608,229,59,35,3549,233
14000US06037207302,6037207302,"Census Tract 2073.02, Los Angeles, CA",3401,212,177,71,3224,207
14000US06037207400,6037207400,"Census Tract 2074, Los Angeles, CA",374,40,0,12,374,40
14000US06037207501,6037207501,"Census Tract 2075.01, Los Angeles, CA",1395,151,275,79,1120,139
14000US06037207502,6037207502,"Census Tract 2075.02, Los Angeles, CA",2196,139,0,12,2196,139
14000US06037207710,6037207710,"Census Tract 2077.10, Los Angeles, CA",3259,219,356,105,2903,241
14000US06037207900,6037207900,"Census Tract 2079, Los Angeles, CA",4204,300,760,177,3444,319
14000US06037208000,6037208000,"Census Tract 2080, Los Angeles, CA",2655,48,110,61,2545,74
14000US06037208301,6037208301,"Census Tract 2083.01, Los Angeles, CA",556,22,0,12,556,22
14000US06037208302,6037208302,"Census Tract 2083.02, Los Angeles, CA",1661,73,103,48,1558,90
14000US06037208401,6037208401,"Census Tract 2084.01, Los Angeles, CA",1515,54,33,24,1482,56
14000US06037208402,6037208402,"Census Tract 2084.02, Los Angeles, CA",827,50,148,41,679,59
14000US06037208501,6037208501,"Census Tract 2085.01, Los Angeles, CA",814,61,83,37,731,68
14000US06037208502,6037208502,"Census Tract 2085.02, Los Angeles, CA",1325,59,14,21,1311,61
14000US06037208610,6037208610,"Census Tract 2086.10, Los Angeles, CA",1470,75,122,48,1348,86
14000US06037208620,6037208620,"Census Tract 2086.20, Los Angeles, CA",1694,94,158,53,1536,102
14000US06037208710,6037208710,"Census Tract 2087.10, Los Angeles, CA",2043,65,327,85,1716,105
14000US06037208720,6037208720,"Census Tract 2087.20, Los Angeles, CA",1590,72,30,33,1560,77
14000US06037208801,6037208801,"Census Tract 2088.01, Los Angeles, CA",1313,71,0,12,1313,71
14000US06037208802,6037208802,"Census Tract 2088.02, Los Angeles, CA",1444,78,23,24,1421,79
14000US06037208902,6037208902,"Census Tract 2089.02, Los Angeles, CA",685,46,0,12,685,46
14000US06037208903,6037208903,"Census Tract 2089.03, Los Angeles, CA",1164,81,9,15,1155,82
14000US06037208904,6037208904,"Census Tract 2089.04, Los Angeles, CA",1291,70,21,24,1270,73
14000US06037209102,6037209102,"Census Tract 2091.02, Los Angeles, CA",2155,66,41,38,2114,69
14000US06037209103,6037209103,"Census Tract 2091.03, Los Angeles, CA",1104,41,9,14,1095,45
14000US06037209104,6037209104,"Census Tract 2091.04, Los Angeles, CA",937,46,0,12,937,46
14000US06037209200,6037209200,"Census Tract 2092, Los Angeles, CA",2212,142,187,73,2025,145
14000US06037209300,6037209300,"Census Tract 2093, Los Angeles, CA",1992,114,39,37,1953,114
14000US06037209401,6037209401,"Census Tract 2094.01, Los Angeles, CA",1589,66,8,14,1581,69
14000US06037209402,6037209402,"Census Tract 2094.02, Los Angeles, CA",1230,68,37,26,1193,71
14000US06037209403,6037209403,"Census Tract 2094.03, Los Angeles, CA",1404,59,14,22,1390,63
14000US06037209510,6037209510,"Census Tract 2095.10, Los Angeles, CA",1000,47,23,24,977,53
14000US06037209520,6037209520,"Census Tract 2095.20, Los Angeles, CA",939,64,9,12,930,66
14000US06037209810,6037209810,"Census Tract 2098.10, Los Angeles, CA",713,41,21,18,692,43
14000US06037209820,6037209820,"Census Tract 2098.20, Los Angeles, CA",823,52,86,43,737,60
14000US06037210010,6037210010,"Census Tract 2100.10, Los Angeles, CA",1227,66,134,53,1093,74
14000US06037211000,6037211000,"Census Tract 2110, Los Angeles, CA",1948,157,1213,148,735,126
14000US06037211120,6037211120,"Census Tract 2111.20, Los Angeles, CA",2547,197,161,92,2386,196
14000US06037211121,6037211121,"Census Tract 2111.21, Los Angeles, CA",844,75,48,37,796,85
14000US06037211122,6037211122,"Census Tract 2111.22, Los Angeles, CA",1233,88,34,41,1199,94
14000US06037211201,6037211201,"Census Tract 2112.01, Los Angeles, CA",869,60,62,29,807,67
14000US06037211202,6037211202,"Census Tract 2112.02, Los Angeles, CA",880,70,26,17,854,68
14000US06037211310,6037211310,"Census Tract 2113.10, Los Angeles, CA",1220,87,58,40,1162,97
14000US06037211320,6037211320,"Census Tract 2113.20, Los Angeles, CA",1286,81,13,21,1273,79
14000US06037211410,6037211410,"Census Tract 2114.10, Los Angeles, CA",1107,81,64,45,1043,91
14000US06037211420,6037211420,"Census Tract 2114.20, Los Angeles, CA",1337,68,186,56,1151,77
14000US06037211500,6037211500,"Census Tract 2115, Los Angeles, CA",1661,105,585,96,1076,119
14000US06037211701,6037211701,"Census Tract 2117.01, Los Angeles, CA",1025,128,303,79,722,112
14000US06037211703,6037211703,"Census Tract 2117.03, Los Angeles, CA",2114,104,186,91,1928,119
14000US06037211704,6037211704,"Census Tract 2117.04, Los Angeles, CA",1612,106,192,72,1420,133
14000US06037211802,6037211802,"Census Tract 2118.02, Los Angeles, CA",2140,126,257,76,1883,152
14000US06037211803,6037211803,"Census Tract 2118.03, Los Angeles, CA",1500,111,132,59,1368,113
14000US06037211804,6037211804,"Census Tract 2118.04, Los Angeles, CA",1320,88,88,50,1232,97
14000US06037211910,6037211910,"Census Tract 2119.10, Los Angeles, CA",1735,137,52,30,1683,142
14000US06037211921,6037211921,"Census Tract 2119.21, Los Angeles, CA",1011,88,14,21,997,90
14000US06037211922,6037211922,"Census Tract 2119.22, Los Angeles, CA",1301,95,18,21,1283,98
14000US06037212101,6037212101,"Census Tract 2121.01, Los Angeles, CA",1467,68,84,40,1383,81
14000US06037212102,6037212102,"Census Tract 2121.02, Los Angeles, CA",1196,107,17,20,1179,107
14000US06037212202,6037212202,"Census Tract 2122.02, Los Angeles, CA",1191,91,23,24,1168,93
14000US06037212203,6037212203,"Census Tract 2122.03, Los Angeles, CA",1564,103,0,12,1564,103
14000US06037212204,6037212204,"Census Tract 2122.04, Los Angeles, CA",1317,57,25,25,1292,64
14000US06037212303,6037212303,"Census Tract 2123.03, Los Angeles, CA",1529,115,7,13,1522,114
14000US06037212304,6037212304,"Census Tract 2123.04, Los Angeles, CA",807,51,0,12,807,51
14000US06037212305,6037212305,"Census Tract 2123.05, Los Angeles, CA",1048,58,7,13,1041,59
14000US06037212306,6037212306,"Census Tract 2123.06, Los Angeles, CA",1212,60,44,27,1168,65
14000US06037212410,6037212410,"Census Tract 2124.10, Los Angeles, CA",1676,94,25,22,1651,95
14000US06037212420,6037212420,"Census Tract 2124.20, Los Angeles, CA",1239,70,86,47,1153,87
14000US06037212501,6037212501,"Census Tract 2125.01, Los Angeles, CA",975,48,37,27,938,54
14000US06037212502,6037212502,"Census Tract 2125.02, Los Angeles, CA",1289,96,81,43,1208,97
14000US06037212610,6037212610,"Census Tract 2126.10, Los Angeles, CA",1823,87,301,81,1522,89
14000US06037212620,6037212620,"Census Tract 2126.20, Los Angeles, CA",1807,92,119,65,1688,103
14000US06037212701,6037212701,"Census Tract 2127.01, Los Angeles, CA",812,59,315,44,497,67
14000US06037212702,6037212702,"Census Tract 2127.02, Los Angeles, CA",1461,77,743,89,718,103
14000US06037212800,6037212800,"Census Tract 2128, Los Angeles, CA",1429,77,537,113,892,136
14000US06037212900,6037212900,"Census Tract 2129, Los Angeles, CA",1548,74,186,72,1362,99
14000US06037213100,6037213100,"Census Tract 2131, Los Angeles, CA",954,42,297,52,657,60
14000US06037213201,6037213201,"Census Tract 2132.01, Los Angeles, CA",1507,102,124,60,1383,118
14000US06037213202,6037213202,"Census Tract 2132.02, Los Angeles, CA",1287,81,236,78,1051,110
14000US06037213310,6037213310,"Census Tract 2133.10, Los Angeles, CA",1058,107,141,67,917,127
14000US06037213320,6037213320,"Census Tract 2133.20, Los Angeles, CA",1060,64,100,49,960,70
14000US06037213401,6037213401,"Census Tract 2134.01, Los Angeles, CA",1696,74,0,12,1696,74
14000US06037213402,6037213402,"Census Tract 2134.02, Los Angeles, CA",1619,89,108,49,1511,104
14000US06037214000,6037214000,"Census Tract 2140, Los Angeles, CA",1364,57,937,111,427,97
14000US06037214100,6037214100,"Census Tract 2141, Los Angeles, CA",1627,107,643,118,984,119
14000US06037214400,6037214400,"Census Tract 2144, Los Angeles, CA",1667,116,47,34,1620,117
14000US06037214501,6037214501,"Census Tract 2145.01, Los Angeles, CA",1404,110,53,34,1351,116
14000US06037214502,6037214502,"Census Tract 2145.02, Los Angeles, CA",2518,179,45,54,2473,182
14000US06037214503,6037214503,"Census Tract 2145.03, Los Angeles, CA",1516,85,13,14,1503,85
14000US06037214600,6037214600,"Census Tract 2146, Los Angeles, CA",1319,90,275,80,1044,112
14000US06037214700,6037214700,"Census Tract 2147, Los Angeles, CA",1160,102,432,86,728,103
14000US06037214800,6037214800,"Census Tract 2148, Los Angeles, CA",1396,105,385,101,1011,126
14000US06037214901,6037214901,"Census Tract 2149.01, Los Angeles, CA",2022,209,474,157,1548,226
14000US06037214902,6037214902,"Census Tract 2149.02, Los Angeles, CA",1534,134,288,93,1246,161
14000US06037215101,6037215101,"Census Tract 2151.01, Los Angeles, CA",1708,103,130,71,1578,107
14000US06037215102,6037215102,"Census Tract 2151.02, Los Angeles, CA",1995,145,28,33,1967,154
14000US06037216100,6037216100,"Census Tract 2161, Los Angeles, CA",977,76,545,82,432,104
14000US06037216200,6037216200,"Census Tract 2162, Los Angeles, CA",2811,199,658,140,2153,244
14000US06037216300,6037216300,"Census Tract 2163, Los Angeles, CA",2101,240,614,134,1487,217
14000US06037216401,6037216401,"Census Tract 2164.01, Los Angeles, CA",1807,218,180,85,1627,219
14000US06037216402,6037216402,"Census Tract 2164.02, Los Angeles, CA",1266,106,106,45,1160,111
14000US06037216700,6037216700,"Census Tract 2167, Los Angeles, CA",1628,104,628,90,1000,121
14000US06037216800,6037216800,"Census Tract 2168, Los Angeles, CA",1327,106,446,83,881,119
14000US06037216900,6037216900,"Census Tract 2169, Los Angeles, CA",2471,153,1169,176,1302,176
14000US06037217001,6037217001,"Census Tract 2170.01, Los Angeles, CA",944,67,440,60,504,78
14000US06037217002,6037217002,"Census Tract 2170.02, Los Angeles, CA",2025,183,586,124,1439,193
14000US06037217100,6037217100,"Census Tract 2171, Los Angeles, CA",2433,128,682,191,1751,239
14000US06037217200,6037217200,"Census Tract 2172, Los Angeles, CA",1608,87,399,96,1209,114
14000US06037218110,6037218110,"Census Tract 2181.10, Los Angeles, CA",1094,75,310,82,784,98
14000US06037218120,6037218120,"Census Tract 2181.20, Los Angeles, CA",1363,106,285,102,1078,125
14000US06037218210,6037218210,"Census Tract 2182.10, Los Angeles, CA",1193,93,253,78,940,118
14000US06037218220,6037218220,"Census Tract 2182.20, Los Angeles, CA",1461,90,515,106,946,97
14000US06037218300,6037218300,"Census Tract 2183, Los Angeles, CA",2127,120,593,143,1534,161
14000US06037218400,6037218400,"Census Tract 2184, Los Angeles, CA",1405,109,419,104,986,150
14000US06037218500,6037218500,"Census Tract 2185, Los Angeles, CA",991,62,330,67,661,74
14000US06037218600,6037218600,"Census Tract 2186, Los Angeles, CA",1098,58,264,76,834,106
14000US06037218701,6037218701,"Census Tract 2187.01, Los Angeles, CA",879,51,332,56,547,58
14000US06037218702,6037218702,"Census Tract 2187.02, Los Angeles, CA",836,43,189,44,647,52
14000US06037218800,6037218800,"Census Tract 2188, Los Angeles, CA",967,45,200,56,767,66
14000US06037218900,6037218900,"Census Tract 2189, Los Angeles, CA",2140,106,267,95,1873,143
14000US06037219010,6037219010,"Census Tract 2190.10, Los Angeles, CA",919,46,429,64,490,68
14000US06037219020,6037219020,"Census Tract 2190.20, Los Angeles, CA",1462,110,690,122,772,143
14000US06037219300,6037219300,"Census Tract 2193, Los Angeles, CA",1480,69,348,87,1132,108
14000US06037219500,6037219500,"Census Tract 2195, Los Angeles, CA",779,44,573,63,206,61
14000US06037219700,6037219700,"Census Tract 2197, Los Angeles, CA",1377,99,673,102,704,130
14000US06037219800,6037219800,"Census Tract 2198, Los Angeles, CA",982,53,293,62,689,81
14000US06037219901,6037219901,"Census Tract 2199.01, Los Angeles, CA",1430,98,367,94,1063,129
14000US06037219902,6037219902,"Census Tract 2199.02, Los Angeles, CA",1219,83,574,104,645,127
14000US06037220000,6037220000,"Census Tract 2200, Los Angeles, CA",1982,145,660,140,1322,192
14000US06037220100,6037220100,"Census Tract 2201, Los Angeles, CA",989,106,494,108,495,123
14000US06037221110,6037221110,"Census Tract 2211.10, Los Angeles, CA",1014,80,117,66,897,96
14000US06037221120,6037221120,"Census Tract 2211.20, Los Angeles, CA",837,42,77,32,760,49
14000US06037221210,6037221210,"Census Tract 2212.10, Los Angeles, CA",874,48,232,50,642,71
14000US06037221220,6037221220,"Census Tract 2212.20, Los Angeles, CA",1008,56,167,49,841,70
14000US06037221302,6037221302,"Census Tract 2213.02, Los Angeles, CA",1318,85,130,73,1188,96
14000US06037221303,6037221303,"Census Tract 2213.03, Los Angeles, CA",754,51,112,30,642,60
14000US06037221304,6037221304,"Census Tract 2213.04, Los Angeles, CA",1139,52,37,29,1102,58
14000US06037221401,6037221401,"Census Tract 2214.01, Los Angeles, CA",1237,114,219,75,1018,122
14000US06037221402,6037221402,"Census Tract 2214.02, Los Angeles, CA",896,53,225,52,671,58
14000US06037221500,6037221500,"Census Tract 2215, Los Angeles, CA",1137,101,171,62,966,111
14000US06037221601,6037221601,"Census Tract 2216.01, Los Angeles, CA",954,44,179,58,775,77
14000US06037221602,6037221602,"Census Tract 2216.02, Los Angeles, CA",942,34,117,38,825,45
14000US06037221710,6037221710,"Census Tract 2217.10, Los Angeles, CA",959,37,185,56,774,62
14000US06037221810,6037221810,"Census Tract 2218.10, Los Angeles, CA",920,46,83,33,837,54
14000US06037221820,6037221820,"Census Tract 2218.20, Los Angeles, CA",914,97,33,20,881,95
14000US06037221900,6037221900,"Census Tract 2219, Los Angeles, CA",902,80,37,39,865,80
14000US06037222001,6037222001,"Census Tract 2220.01, Los Angeles, CA",928,59,486,76,442,90
14000US06037222002,6037222002,"Census Tract 2220.02, Los Angeles, CA",1351,78,521,135,830,150
14000US06037222100,6037222100,"Census Tract 2221, Los Angeles, CA",1208,57,451,85,757,82
14000US06037222200,6037222200,"Census Tract 2222, Los Angeles, CA",1196,84,249,95,947,115
14000US06037222500,6037222500,"Census Tract 2225, Los Angeles, CA",1260,71,488,83,772,96
14000US06037222600,6037222600,"Census Tract 2226, Los Angeles, CA",1684,77,258,73,1426,103
14000US06037222700,6037222700,"Census Tract 2227, Los Angeles, CA",135,41,0,12,135,41
14000US06037224010,6037224010,"Census Tract 2240.10, Los Angeles, CA",1533,106,10,22,1523,109
14000US06037224020,6037224020,"Census Tract 2240.20, Los Angeles, CA",943,63,49,29,894,69
14000US06037224200,6037224200,"Census Tract 2242, Los Angeles, CA",737,36,60,32,677,49
14000US06037224310,6037224310,"Census Tract 2243.10, Los Angeles, CA",660,33,81,44,579,56
14000US06037224320,6037224320,"Census Tract 2243.20, Los Angeles, CA",1125,46,79,47,1046,71
14000US06037224410,6037224410,"Census Tract 2244.10, Los Angeles, CA",1090,67,229,86,861,106
14000US06037224420,6037224420,"Census Tract 2244.20, Los Angeles, CA",753,43,62,28,691,46
14000US06037224600,6037224600,"Census Tract 2246, Los Angeles, CA",819,53,104,35,715,67
14000US06037224700,6037224700,"Census Tract 2247, Los Angeles, CA",949,64,18,16,931,62
14000US06037226001,6037226001,"Census Tract 2260.01, Los Angeles, CA",604,33,95,43,509,48
14000US06037226002,6037226002,"Census Tract 2260.02, Los Angeles, CA",1108,62,134,44,974,75
14000US06037226410,6037226410,"Census Tract 2264.10, Los Angeles, CA",884,29,123,46,761,55
14000US06037226420,6037226420,"Census Tract 2264.20, Los Angeles, CA",1284,75,305,78,979,108
14000US06037226700,6037226700,"Census Tract 2267, Los Angeles, CA",1517,41,316,100,1201,110
14000US06037227010,6037227010,"Census Tract 2270.10, Los Angeles, CA",1128,71,241,87,887,117
14000US06037227020,6037227020,"Census Tract 2270.20, Los Angeles, CA",770,39,207,58,563,67
14000US06037228100,6037228100,"Census Tract 2281, Los Angeles, CA",1016,90,302,87,714,130
14000US06037228210,6037228210,"Census Tract 2282.10, Los Angeles, CA",1003,51,272,58,731,65
14000US06037228220,6037228220,"Census Tract 2282.20, Los Angeles, CA",922,58,314,65,608,89
14000US06037228310,6037228310,"Census Tract 2283.10, Los Angeles, CA",1044,42,226,63,818,67
14000US06037228320,6037228320,"Census Tract 2283.20, Los Angeles, CA",709,48,200,57,509,72
14000US06037228410,6037228410,"Census Tract 2284.10, Los Angeles, CA",723,34,186,55,537,57
14000US06037228420,6037228420,"Census Tract 2284.20, Los Angeles, CA",715,42,152,50,563,59
14000US06037228500,6037228500,"Census Tract 2285, Los Angeles, CA",1188,62,267,87,921,98
14000US06037228600,6037228600,"Census Tract 2286, Los Angeles, CA",1159,43,350,91,809,100
14000US06037228710,6037228710,"Census Tract 2287.10, Los Angeles, CA",995,57,185,58,810,73
14000US06037228720,6037228720,"Census Tract 2287.20, Los Angeles, CA",1044,40,318,72,726,85
14000US06037228800,6037228800,"Census Tract 2288, Los Angeles, CA",1189,69,457,90,732,105
14000US06037228900,6037228900,"Census Tract 2289, Los Angeles, CA",714,60,101,46,613,73
14000US06037229100,6037229100,"Census Tract 2291, Los Angeles, CA",1021,39,356,67,665,74
14000US06037229200,6037229200,"Census Tract 2292, Los Angeles, CA",1184,61,316,81,868,98
14000US06037229300,6037229300,"Census Tract 2293, Los Angeles, CA",1370,63,406,85,964,119
14000US06037229410,6037229410,"Census Tract 2294.10, Los Angeles, CA",813,42,196,70,617,75
14000US06037229420,6037229420,"Census Tract 2294.20, Los Angeles, CA",1118,26,396,67,722,64
14000US06037231100,6037231100,"Census Tract 2311, Los Angeles, CA",692,53,64,39,628,66
14000US06037231210,6037231210,"Census Tract 2312.10, Los Angeles, CA",1156,57,157,73,999,104
14000US06037231220,6037231220,"Census Tract 2312.20, Los Angeles, CA",1284,65,155,62,1129,87
14000US06037231300,6037231300,"Census Tract 2313, Los Angeles, CA",1714,70,597,179,1117,184
14000US06037231400,6037231400,"Census Tract 2314, Los Angeles, CA",1554,74,621,120,933,120
14000US06037231500,6037231500,"Census Tract 2315, Los Angeles, CA",1443,77,805,99,638,106
14000US06037231600,6037231600,"Census Tract 2316, Los Angeles, CA",2072,92,637,128,1435,146
14000US06037231710,6037231710,"Census Tract 2317.10, Los Angeles, CA",1323,60,124,70,1199,87
14000US06037231720,6037231720,"Census Tract 2317.20, Los Angeles, CA",1524,89,262,70,1262,112
14000US06037231800,6037231800,"Census Tract 2318, Los Angeles, CA",1410,78,185,52,1225,95
14000US06037231900,6037231900,"Census Tract 2319, Los Angeles, CA",1541,81,482,117,1059,119
14000US06037232110,6037232110,"Census Tract 2321.10, Los Angeles, CA",886,51,184,53,702,72
14000US06037232120,6037232120,"Census Tract 2321.20, Los Angeles, CA",1357,107,254,89,1103,142
14000US06037232200,6037232200,"Census Tract 2322, Los Angeles, CA",909,49,339,60,570,85
14000US06037232300,6037232300,"Census Tract 2323, Los Angeles, CA",1143,77,611,135,532,138
14000US06037232400,6037232400,"Census Tract 2324, Los Angeles, CA",1943,96,965,119,978,141
14000US06037232500,6037232500,"Census Tract 2325, Los Angeles, CA",1471,81,717,132,754,135
14000US06037232600,6037232600,"Census Tract 2326, Los Angeles, CA",1909,69,865,166,1044,157
14000US06037232700,6037232700,"Census Tract 2327, Los Angeles, CA",1642,67,574,111,1068,132
14000US06037232800,6037232800,"Census Tract 2328, Los Angeles, CA",995,35,315,67,680,69
14000US06037234000,6037234000,"Census Tract 2340, Los Angeles, CA",2032,82,1265,168,767,155
14000US06037234200,6037234200,"Census Tract 2342, Los Angeles, CA",1167,44,842,93,325,100
14000US06037234300,6037234300,"Census Tract 2343, Los Angeles, CA",2276,200,420,141,1856,209
14000US06037234501,6037234501,"Census Tract 2345.01, Los Angeles, CA",929,63,681,75,248,76
14000US06037234502,6037234502,"Census Tract 2345.02, Los Angeles, CA",1196,64,342,103,854,127
14000US06037234600,6037234600,"Census Tract 2346, Los Angeles, CA",1706,93,1184,137,522,135
14000US06037234700,6037234700,"Census Tract 2347, Los Angeles, CA",1447,115,691,150,756,153
14000US06037234800,6037234800,"Census Tract 2348, Los Angeles, CA",1207,45,721,96,486,99
14000US06037234901,6037234901,"Census Tract 2349.01, Los Angeles, CA",1125,89,32,29,1093,85
14000US06037234902,6037234902,"Census Tract 2349.02, Los Angeles, CA",1570,110,350,106,1220,152
14000US06037235100,6037235100,"Census Tract 2351, Los Angeles, CA",1674,100,1299,121,375,104
14000US06037235201,6037235201,"Census Tract 2352.01, Los Angeles, CA",979,50,671,84,308,82
14000US06037235202,6037235202,"Census Tract 2352.02, Los Angeles, CA",1941,81,648,113,1293,121
14000US06037236000,6037236000,"Census Tract 2360, Los Angeles, CA",2189,104,1724,172,465,155
14000US06037236100,6037236100,"Census Tract 2361, Los Angeles, CA",2986,151,485,146,2501,214
14000US06037236202,6037236202,"Census Tract 2362.02, Los Angeles, CA",2510,135,35,40,2475,132
14000US06037236203,6037236203,"Census Tract 2362.03, Los Angeles, CA",1472,90,17,27,1455,97
14000US06037236204,6037236204,"Census Tract 2362.04, Los Angeles, CA",1373,78,0,12,1373,78
14000US06037236400,6037236400,"Census Tract 2364, Los Angeles, CA",2105,112,1090,134,1015,158
14000US06037237101,6037237101,"Census Tract 2371.01, Los Angeles, CA",1169,47,302,74,867,73
14000US06037237102,6037237102,"Census Tract 2371.02, Los Angeles, CA",931,53,270,62,661,71
14000US06037237201,6037237201,"Census Tract 2372.01, Los Angeles, CA",1011,46,433,75,578,80
14000US06037237202,6037237202,"Census Tract 2372.02, Los Angeles, CA",1394,58,676,116,718,122
14000US06037237300,6037237300,"Census Tract 2373, Los Angeles, CA",1917,94,1011,143,906,145
14000US06037237401,6037237401,"Census Tract 2374.01, Los Angeles, CA",1095,49,548,77,547,92
14000US06037237402,6037237402,"Census Tract 2374.02, Los Angeles, CA",1031,63,633,88,398,82
14000US06037237500,6037237500,"Census Tract 2375, Los Angeles, CA",882,39,144,46,738,55
14000US06037237600,6037237600,"Census Tract 2376, Los Angeles, CA",1230,51,289,93,941,99
14000US06037237710,6037237710,"Census Tract 2377.10, Los Angeles, CA",1144,74,197,82,947,113
14000US06037237720,6037237720,"Census Tract 2377.20, Los Angeles, CA",906,47,170,66,736,79
14000US06037237800,6037237800,"Census Tract 2378, Los Angeles, CA",1398,75,845,130,553,134
14000US06037237900,6037237900,"Census Tract 2379, Los Angeles, CA",1408,68,940,131,468,126
14000US06037238000,6037238000,"Census Tract 2380, Los Angeles, CA",2342,129,1334,254,1008,258
14000US06037238100,6037238100,"Census Tract 2381, Los Angeles, CA",1823,75,883,128,940,130
14000US06037238200,6037238200,"Census Tract 2382, Los Angeles, CA",2172,179,1006,218,1166,245
14000US06037238310,6037238310,"Census Tract 2383.10, Los Angeles, CA",1492,43,133,71,1359,77
14000US06037238320,6037238320,"Census Tract 2383.20, Los Angeles, CA",1143,66,178,55,965,71
14000US06037238400,6037238400,"Census Tract 2384, Los Angeles, CA",1906,74,1189,121,717,121
14000US06037239201,6037239201,"Census Tract 2392.01, Los Angeles, CA",958,30,165,61,793,65
14000US06037239202,6037239202,"Census Tract 2392.02, Los Angeles, CA",1176,51,317,86,859,96
14000US06037239310,6037239310,"Census Tract 2393.10, Los Angeles, CA",1009,67,245,72,764,81
14000US06037239320,6037239320,"Census Tract 2393.20, Los Angeles, CA",848,42,319,64,529,76
14000US06037239330,6037239330,"Census Tract 2393.30, Los Angeles, CA",683,53,235,57,448,66
14000US06037239501,6037239501,"Census Tract 2395.01, Los Angeles, CA",927,50,330,74,597,77
14000US06037239502,6037239502,"Census Tract 2395.02, Los Angeles, CA",920,40,330,62,590,64
14000US06037239601,6037239601,"Census Tract 2396.01, Los Angeles, CA",891,63,255,59,636,82
14000US06037239602,6037239602,"Census Tract 2396.02, Los Angeles, CA",893,51,248,61,645,74
14000US06037239701,6037239701,"Census Tract 2397.01, Los Angeles, CA",1114,41,297,100,817,113
14000US06037239702,6037239702,"Census Tract 2397.02, Los Angeles, CA",1096,50,283,65,813,87
14000US06037239801,6037239801,"Census Tract 2398.01, Los Angeles, CA",893,60,279,69,614,75
14000US06037239802,6037239802,"Census Tract 2398.02, Los Angeles, CA",1393,62,433,92,960,106
14000US06037240010,6037240010,"Census Tract 2400.10, Los Angeles, CA",984,77,210,57,774,86
14000US06037240020,6037240020,"Census Tract 2400.20, Los Angeles, CA",1283,66,620,107,663,115
14000US06037240200,6037240200,"Census Tract 2402, Los Angeles, CA",1406,81,316,83,1090,100
14000US06037240300,6037240300,"Census Tract 2403, Los Angeles, CA",1636,126,339,121,1297,165
14000US06037240401,6037240401,"Census Tract 2404.01, Los Angeles, CA",1486,85,436,97,1050,127
14000US06037240402,6037240402,"Census Tract 2404.02, Los Angeles, CA",1224,41,590,100,634,105
14000US06037240500,6037240500,"Census Tract 2405, Los Angeles, CA",1737,72,484,107,1253,119
14000US06037240600,6037240600,"Census Tract 2406, Los Angeles, CA",1316,77,421,101,895,106
14000US06037240700,6037240700,"Census Tract 2407, Los Angeles, CA",1695,79,726,123,969,124
14000US06037240800,6037240800,"Census Tract 2408, Los Angeles, CA",1154,25,562,88,592,87
14000US06037240900,6037240900,"Census Tract 2409, Los Angeles, CA",1483,59,640,140,843,149
14000US06037241001,6037241001,"Census Tract 2410.01, Los Angeles, CA",1163,72,500,101,663,132
14000US06037241002,6037241002,"Census Tract 2410.02, Los Angeles, CA",1039,48,446,62,593,72
14000US06037241110,6037241110,"Census Tract 2411.10, Los Angeles, CA",795,39,301,65,494,62
14000US06037241120,6037241120,"Census Tract 2411.20, Los Angeles, CA",1319,62,439,118,880,132
14000US06037241201,6037241201,"Census Tract 2412.01, Los Angeles, CA",868,60,491,68,377,69
14000US06037241202,6037241202,"Census Tract 2412.02, Los Angeles, CA",1596,78,638,113,958,128
14000US06037241300,6037241300,"Census Tract 2413, Los Angeles, CA",744,37,327,55,417,61
14000US06037241400,6037241400,"Census Tract 2414, Los Angeles, CA",962,51,326,66,636,70
14000US06037242000,6037242000,"Census Tract 2420, Los Angeles, CA",1074,54,332,72,742,75
14000US06037242100,6037242100,"Census Tract 2421, Los Angeles, CA",751,40,2,4,749,39
14000US06037242200,6037242200,"Census Tract 2422, Los Angeles, CA",1661,64,546,117,1115,132
14000US06037242300,6037242300,"Census Tract 2423, Los Angeles, CA",1276,78,296,115,980,130
14000US06037242600,6037242600,"Census Tract 2426, Los Angeles, CA",1381,46,151,56,1230,74
14000US06037242700,6037242700,"Census Tract 2427, Los Angeles, CA",1281,63,634,102,647,104
14000US06037243000,6037243000,"Census Tract 2430, Los Angeles, CA",1350,100,803,108,547,125
14000US06037243100,6037243100,"Census Tract 2431, Los Angeles, CA",1530,49,450,86,1080,96
14000US06037261101,6037261101,"Census Tract 2611.01, Los Angeles, CA",1381,109,1217,123,164,96
14000US06037261102,6037261102,"Census Tract 2611.02, Los Angeles, CA",1467,123,1377,119,90,51
14000US06037261200,6037261200,"Census Tract 2612, Los Angeles, CA",1603,124,1314,146,289,102
14000US06037262100,6037262100,"Census Tract 2621, Los Angeles, CA",1131,125,988,124,143,80
14000US06037262200,6037262200,"Census Tract 2622, Los Angeles, CA",1766,125,1405,137,361,110
14000US06037262301,6037262301,"Census Tract 2623.01, Los Angeles, CA",859,52,807,54,52,30
14000US06037262302,6037262302,"Census Tract 2623.02, Los Angeles, CA",1194,84,852,96,342,91
14000US06037262303,6037262303,"Census Tract 2623.03, Los Angeles, CA",1086,92,1040,100,46,37
14000US06037262400,6037262400,"Census Tract 2624, Los Angeles, CA",1101,116,989,106,112,63
14000US06037262501,6037262501,"Census Tract 2625.01, Los Angeles, CA",1397,81,1169,98,228,96
14000US06037262601,6037262601,"Census Tract 2626.01, Los Angeles, CA",1349,89,1200,104,149,62
14000US06037262604,6037262604,"Census Tract 2626.04, Los Angeles, CA",2417,176,1978,183,439,152
14000US06037262704,6037262704,"Census Tract 2627.04, Los Angeles, CA",1609,114,995,114,614,118
14000US06037262706,6037262706,"Census Tract 2627.06, Los Angeles, CA",1314,79,985,95,329,101
14000US06037262802,6037262802,"Census Tract 2628.02, Los Angeles, CA",1327,134,1030,119,297,84
14000US06037264000,6037264000,"Census Tract 2640, Los Angeles, CA",1211,77,914,124,297,98
14000US06037264102,6037264102,"Census Tract 2641.02, Los Angeles, CA",1649,107,593,116,1056,122
14000US06037264103,6037264103,"Census Tract 2641.03, Los Angeles, CA",1464,97,341,90,1123,109
14000US06037264301,6037264301,"Census Tract 2643.01, Los Angeles, CA",3169,148,614,157,2555,192
14000US06037264302,6037264302,"Census Tract 2643.02, Los Angeles, CA",2962,156,1037,177,1925,203
14000US06037265100,6037265100,"Census Tract 2651, Los Angeles, CA",1264,120,800,91,464,122
14000US06037265201,6037265201,"Census Tract 2652.01, Los Angeles, CA",860,102,516,75,344,89
14000US06037265202,6037265202,"Census Tract 2652.02, Los Angeles, CA",1873,206,574,146,1299,206
14000US06037265301,6037265301,"Census Tract 2653.01, Los Angeles, CA",0,19,0,19,0,19
14000US06037265303,6037265303,"Census Tract 2653.03, Los Angeles, CA",1477,88,68,51,1409,89
14000US06037265304,6037265304,"Census Tract 2653.04, Los Angeles, CA",839,93,0,12,839,93
14000US06037265305,6037265305,"Census Tract 2653.05, Los Angeles, CA",1575,149,0,12,1575,149
14000US06037265410,6037265410,"Census Tract 2654.10, Los Angeles, CA",610,55,360,56,250,47
14000US06037265420,6037265420,"Census Tract 2654.20, Los Angeles, CA",751,49,474,70,277,69
14000US06037265510,6037265510,"Census Tract 2655.10, Los Angeles, CA",2200,172,284,115,1916,172
14000US06037265520,6037265520,"Census Tract 2655.20, Los Angeles, CA",2290,159,837,139,1453,175
14000US06037265601,6037265601,"Census Tract 2656.01, Los Angeles, CA",1372,71,515,89,857,100
14000US06037265602,6037265602,"Census Tract 2656.02, Los Angeles, CA",1455,137,858,148,597,149
14000US06037265700,6037265700,"Census Tract 2657, Los Angeles, CA",2393,171,973,164,1420,219
14000US06037267100,6037267100,"Census Tract 2671, Los Angeles, CA",2867,177,1419,200,1448,211
14000US06037267200,6037267200,"Census Tract 2672, Los Angeles, CA",2941,135,1021,152,1920,206
14000US06037267300,6037267300,"Census Tract 2673, Los Angeles, CA",2022,160,257,105,1765,155
14000US06037267402,6037267402,"Census Tract 2674.02, Los Angeles, CA",2707,134,479,151,2228,185
14000US06037267403,6037267403,"Census Tract 2674.03, Los Angeles, CA",1689,86,259,75,1430,100
14000US06037267404,6037267404,"Census Tract 2674.04, Los Angeles, CA",1622,78,246,86,1376,98
14000US06037267501,6037267501,"Census Tract 2675.01, Los Angeles, CA",2751,135,434,133,2317,166
14000US06037267502,6037267502,"Census Tract 2675.02, Los Angeles, CA",1651,78,412,97,1239,127
14000US06037267600,6037267600,"Census Tract 2676, Los Angeles, CA",1318,81,480,117,838,125
14000US06037267700,6037267700,"Census Tract 2677, Los Angeles, CA",1665,116,534,103,1131,126
14000US06037267800,6037267800,"Census Tract 2678, Los Angeles, CA",1164,83,639,85,525,98
14000US06037267901,6037267901,"Census Tract 2679.01, Los Angeles, CA",1421,136,1131,151,290,91
14000US06037267902,6037267902,"Census Tract 2679.02, Los Angeles, CA",1543,121,899,110,644,121
14000US06037269000,6037269000,"Census Tract 2690, Los Angeles, CA",2029,157,1291,144,738,167
14000US06037269100,6037269100,"Census Tract 2691, Los Angeles, CA",1881,135,645,126,1236,130
14000US06037269300,6037269300,"Census Tract 2693, Los Angeles, CA",1489,74,1199,83,290,77
14000US06037269500,6037269500,"Census Tract 2695, Los Angeles, CA",1304,80,1135,117,169,78
14000US06037269601,6037269601,"Census Tract 2696.01, Los Angeles, CA",1035,65,118,54,917,90
14000US06037269602,6037269602,"Census Tract 2696.02, Los Angeles, CA",1161,59,184,66,977,83
14000US06037269700,6037269700,"Census Tract 2697, Los Angeles, CA",1627,108,709,93,918,124
14000US06037269800,6037269800,"Census Tract 2698, Los Angeles, CA",1548,127,272,82,1276,132
14000US06037269903,6037269903,"Census Tract 2699.03, Los Angeles, CA",1705,109,99,47,1606,118
14000US06037269904,6037269904,"Census Tract 2699.04, Los Angeles, CA",2148,169,37,35,2111,176
14000US06037269905,6037269905,"Census Tract 2699.05, Los Angeles, CA",1424,89,0,12,1424,89
14000US06037269906,6037269906,"Census Tract 2699.06, Los Angeles, CA",1564,87,72,37,1492,89
14000US06037269907,6037269907,"Census Tract 2699.07, Los Angeles, CA",1384,94,126,36,1258,92
14000US06037270100,6037270100,"Census Tract 2701, Los Angeles, CA",2332,170,175,70,2157,169
14000US06037270200,6037270200,"Census Tract 2702, Los Angeles, CA",1271,79,441,78,830,107
14000US06037270300,6037270300,"Census Tract 2703, Los Angeles, CA",973,54,544,72,429,77
14000US06037271100,6037271100,"Census Tract 2711, Los Angeles, CA",934,45,599,62,335,65
14000US06037271200,6037271200,"Census Tract 2712, Los Angeles, CA",1177,93,197,60,980,102
14000US06037271300,6037271300,"Census Tract 2713, Los Angeles, CA",2021,102,1321,141,700,131
14000US06037271400,6037271400,"Census Tract 2714, Los Angeles, CA",1310,87,1163,115,147,82
14000US06037271500,6037271500,"Census Tract 2715, Los Angeles, CA",1349,66,714,83,635,103
14000US06037271600,6037271600,"Census Tract 2716, Los Angeles, CA",1936,88,579,78,1357,111
14000US06037271701,6037271701,"Census Tract 2717.01, Los Angeles, CA",2677,181,753,136,1924,182
14000US06037271702,6037271702,"Census Tract 2717.02, Los Angeles, CA",1893,108,470,90,1423,121
14000US06037271801,6037271801,"Census Tract 2718.01, Los Angeles, CA",1604,109,259,78,1345,120
14000US06037271802,6037271802,"Census Tract 2718.02, Los Angeles, CA",2602,145,366,125,2236,184
14000US06037271901,6037271901,"Census Tract 2719.01, Los Angeles, CA",1409,48,515,80,894,88
14000US06037271902,6037271902,"Census Tract 2719.02, Los Angeles, CA",1851,77,586,78,1265,89
14000US06037272100,6037272100,"Census Tract 2721, Los Angeles, CA",1834,78,1030,137,804,138
14000US06037272201,6037272201,"Census Tract 2722.01, Los Angeles, CA",1097,63,158,48,939,78
14000US06037272202,6037272202,"Census Tract 2722.02, Los Angeles, CA",1588,68,280,68,1308,84
14000US06037272301,6037272301,"Census Tract 2723.01, Los Angeles, CA",1293,84,498,95,795,119
14000US06037272302,6037272302,"Census Tract 2723.02, Los Angeles, CA",1862,117,226,65,1636,111
14000US06037273100,6037273100,"Census Tract 2731, Los Angeles, CA",1218,98,554,76,664,93
14000US06037273200,6037273200,"Census Tract 2732, Los Angeles, CA",1532,111,529,100,1003,126
14000US06037273300,6037273300,"Census Tract 2733, Los Angeles, CA",1474,123,347,107,1127,136
14000US06037273402,6037273402,"Census Tract 2734.02, Los Angeles, CA",1816,251,486,162,1330,256
14000US06037273502,6037273502,"Census Tract 2735.02, Los Angeles, CA",1662,125,352,79,1310,123
14000US06037273600,6037273600,"Census Tract 2736, Los Angeles, CA",1081,78,641,91,440,110
14000US06037273700,6037273700,"Census Tract 2737, Los Angeles, CA",1243,74,494,105,749,114
14000US06037273800,6037273800,"Census Tract 2738, Los Angeles, CA",1499,93,505,98,994,122
14000US06037273902,6037273902,"Census Tract 2739.02, Los Angeles, CA",2126,179,810,151,1316,189
14000US06037274100,6037274100,"Census Tract 2741, Los Angeles, CA",2326,176,829,185,1497,240
14000US06037274202,6037274202,"Census Tract 2742.02, Los Angeles, CA",2285,234,1293,221,992,218
14000US06037275101,6037275101,"Census Tract 2751.01, Los Angeles, CA",470,35,175,37,295,45
14000US06037275102,6037275102,"Census Tract 2751.02, Los Angeles, CA",1421,59,420,110,1001,108
14000US06037275200,6037275200,"Census Tract 2752, Los Angeles, CA",1721,80,424,90,1297,115
14000US06037275302,6037275302,"Census Tract 2753.02, Los Angeles, CA",2656,157,1553,200,1103,208
14000US06037275311,6037275311,"Census Tract 2753.11, Los Angeles, CA",2337,86,1016,134,1321,152
14000US06037275400,6037275400,"Census Tract 2754, Los Angeles, CA",2116,115,913,116,1203,146
14000US06037275500,6037275500,"Census Tract 2755, Los Angeles, CA",1907,44,494,78,1413,87
14000US06037275602,6037275602,"Census Tract 2756.02, Los Angeles, CA",5663,262,1903,204,3760,330
14000US06037275603,6037275603,"Census Tract 2756.03, Los Angeles, CA",1188,47,725,97,463,99
14000US06037276000,6037276000,"Census Tract 2760, Los Angeles, CA",2519,209,1753,185,766,180
14000US06037276100,6037276100,"Census Tract 2761, Los Angeles, CA",2837,179,500,126,2337,185
14000US06037276400,6037276400,"Census Tract 2764, Los Angeles, CA",1488,74,1265,101,223,84
14000US06037276500,6037276500,"Census Tract 2765, Los Angeles, CA",710,38,436,51,274,54
14000US06037276601,6037276601,"Census Tract 2766.01, Los Angeles, CA",1624,91,998,92,626,113
14000US06037276603,6037276603,"Census Tract 2766.03, Los Angeles, CA",3179,125,1546,199,1633,204
14000US06037276604,6037276604,"Census Tract 2766.04, Los Angeles, CA",2426,126,754,159,1672,209
14000US06037277000,6037277000,"Census Tract 2770, Los Angeles, CA",2205,82,1601,151,604,166
14000US06037277100,6037277100,"Census Tract 2771, Los Angeles, CA",1125,52,953,88,172,67
14000US06037277200,6037277200,"Census Tract 2772, Los Angeles, CA",1009,91,203,66,806,104
14000US06037277400,6037277400,"Census Tract 2774, Los Angeles, CA",341,76,9,13,332,76
14000US06037278001,6037278001,"Census Tract 2780.01, Los Angeles, CA",993,78,580,95,413,95
14000US06037278102,6037278102,"Census Tract 2781.02, Los Angeles, CA",1514,94,761,120,753,133
14000US06037291110,6037291110,"Census Tract 2911.10, Los Angeles, CA",1340,57,300,75,1040,86
14000US06037291120,6037291120,"Census Tract 2911.20, Los Angeles, CA",648,39,174,35,474,46
14000US06037291130,6037291130,"Census Tract 2911.30, Los Angeles, CA",985,59,679,65,306,65
14000US06037291210,6037291210,"Census Tract 2912.10, Los Angeles, CA",1603,61,787,136,816,144
14000US06037291220,6037291220,"Census Tract 2912.20, Los Angeles, CA",1037,48,402,64,635,77
14000US06037291300,6037291300,"Census Tract 2913, Los Angeles, CA",1107,44,792,65,315,68
14000US06037292000,6037292000,"Census Tract 2920, Los Angeles, CA",1959,82,554,105,1405,126
14000US06037293201,6037293201,"Census Tract 2932.01, Los Angeles, CA",2029,153,808,148,1221,199
14000US06037293202,6037293202,"Census Tract 2932.02, Los Angeles, CA",1782,118,334,81,1448,139
14000US06037293301,6037293301,"Census Tract 2933.01, Los Angeles, CA",1065,57,715,82,350,82
14000US06037293302,6037293302,"Census Tract 2933.02, Los Angeles, CA",1656,77,1001,126,655,132
14000US06037293304,6037293304,"Census Tract 2933.04, Los Angeles, CA",1460,77,485,92,975,113
14000US06037293306,6037293306,"Census Tract 2933.06, Los Angeles, CA",794,43,561,62,233,69
14000US06037293307,6037293307,"Census Tract 2933.07, Los Angeles, CA",914,57,217,53,697,76
14000US06037294110,6037294110,"Census Tract 2941.10, Los Angeles, CA",1114,59,585,92,529,98
14000US06037294120,6037294120,"Census Tract 2941.20, Los Angeles, CA",581,30,273,54,308,54
14000US06037294200,6037294200,"Census Tract 2942, Los Angeles, CA",1367,66,853,111,514,111
14000US06037294301,6037294301,"Census Tract 2943.01, Los Angeles, CA",688,15,504,56,184,56
14000US06037294302,6037294302,"Census Tract 2943.02, Los Angeles, CA",1195,73,544,95,651,110
14000US06037294410,6037294410,"Census Tract 2944.10, Los Angeles, CA",1634,72,656,115,978,113
14000US06037294421,6037294421,"Census Tract 2944.21, Los Angeles, CA",995,50,400,77,595,78
14000US06037294510,6037294510,"Census Tract 2945.10, Los Angeles, CA",1079,69,380,86,699,90
14000US06037294520,6037294520,"Census Tract 2945.20, Los Angeles, CA",906,41,301,62,605,65
14000US06037294610,6037294610,"Census Tract 2946.10, Los Angeles, CA",1160,58,452,94,708,93
14000US06037294620,6037294620,"Census Tract 2946.20, Los Angeles, CA",1099,68,444,87,655,88
14000US06037294701,6037294701,"Census Tract 2947.01, Los Angeles, CA",895,42,120,38,775,54
14000US06037294810,6037294810,"Census Tract 2948.10, Los Angeles, CA",1025,52,123,36,902,60
14000US06037294820,6037294820,"Census Tract 2948.20, Los Angeles, CA",874,40,89,40,785,49
14000US06037294830,6037294830,"Census Tract 2948.30, Los Angeles, CA",1038,34,167,52,871,59
14000US06037294900,6037294900,"Census Tract 2949, Los Angeles, CA",933,36,284,57,649,62
14000US06037295103,6037295103,"Census Tract 2951.03, Los Angeles, CA",1997,115,1654,142,343,119
14000US06037296210,6037296210,"Census Tract 2962.10, Los Angeles, CA",1007,58,215,57,792,72
14000US06037296220,6037296220,"Census Tract 2962.20, Los Angeles, CA",1775,109,127,56,1648,123
14000US06037296300,6037296300,"Census Tract 2963, Los Angeles, CA",2054,99,1253,123,801,129
14000US06037296401,6037296401,"Census Tract 2964.01, Los Angeles, CA",1268,80,968,95,300,89
14000US06037296402,6037296402,"Census Tract 2964.02, Los Angeles, CA",1116,65,865,98,251,93
14000US06037296500,6037296500,"Census Tract 2965, Los Angeles, CA",1306,83,478,108,828,130
14000US06037296600,6037296600,"Census Tract 2966, Los Angeles, CA",1948,121,444,145,1504,176
14000US06037296901,6037296901,"Census Tract 2969.01, Los Angeles, CA",1635,88,221,82,1414,127
14000US06037296902,6037296902,"Census Tract 2969.02, Los Angeles, CA",1678,78,336,101,1342,125
14000US06037297000,6037297000,"Census Tract 2970, Los Angeles, CA",2337,131,1406,183,931,164
14000US06037297110,6037297110,"Census Tract 2971.10, Los Angeles, CA",1558,88,235,70,1323,110
14000US06037297120,6037297120,"Census Tract 2971.20, Los Angeles, CA",1059,102,217,77,842,110
14000US06037297201,6037297201,"Census Tract 2972.01, Los Angeles, CA",1467,66,306,91,1161,114
14000US06037297202,6037297202,"Census Tract 2972.02, Los Angeles, CA",1399,106,611,94,788,135
14000US06037297300,6037297300,"Census Tract 2973, Los Angeles, CA",772,61,335,67,437,75
14000US06037297400,6037297400,"Census Tract 2974, Los Angeles, CA",1506,99,1276,117,230,81
14000US06037297500,6037297500,"Census Tract 2975, Los Angeles, CA",2092,156,1413,168,679,183
14000US06037297601,6037297601,"Census Tract 2976.01, Los Angeles, CA",1213,72,209,72,1004,106
14000US06037297602,6037297602,"Census Tract 2976.02, Los Angeles, CA",1712,86,700,115,1012,135
14000US06037300100,6037300100,"Census Tract 3001, Los Angeles, CA",1946,119,1823,129,123,75
14000US06037300200,6037300200,"Census Tract 3002, Los Angeles, CA",1863,90,1256,106,607,116
14000US06037300301,6037300301,"Census Tract 3003.01, Los Angeles, CA",2061,92,1790,131,271,100
14000US06037300400,6037300400,"Census Tract 3004, Los Angeles, CA",2074,89,1487,160,587,157
14000US06037300501,6037300501,"Census Tract 3005.01, Los Angeles, CA",1055,18,838,82,217,87
14000US06037300502,6037300502,"Census Tract 3005.02, Los Angeles, CA",2409,172,893,180,1516,223
14000US06037300600,6037300600,"Census Tract 3006, Los Angeles, CA",3578,85,1316,191,2262,204
14000US06037300701,6037300701,"Census Tract 3007.01, Los Angeles, CA",2076,134,1717,180,359,156
14000US06037300702,6037300702,"Census Tract 3007.02, Los Angeles, CA",1891,158,1635,176,256,113
14000US06037300800,6037300800,"Census Tract 3008, Los Angeles, CA",2776,133,1462,201,1314,216
14000US06037300901,6037300901,"Census Tract 3009.01, Los Angeles, CA",2203,106,1923,144,280,145
14000US06037300902,6037300902,"Census Tract 3009.02, Los Angeles, CA",741,23,673,42,68,40
14000US06037301000,6037301000,"Census Tract 3010, Los Angeles, CA",2085,102,722,141,1363,156
14000US06037301100,6037301100,"Census Tract 3011, Los Angeles, CA",2818,97,1072,161,1746,188
14000US06037301203,6037301203,"Census Tract 3012.03, Los Angeles, CA",1884,74,750,124,1134,124
14000US06037301204,6037301204,"Census Tract 3012.04, Los Angeles, CA",2123,93,148,85,1975,131
14000US06037301205,6037301205,"Census Tract 3012.05, Los Angeles, CA",747,28,595,61,152,61
14000US06037301206,6037301206,"Census Tract 3012.06, Los Angeles, CA",1861,82,470,101,1391,119
14000US06037301300,6037301300,"Census Tract 3013, Los Angeles, CA",700,23,637,35,63,30
14000US06037301400,6037301400,"Census Tract 3014, Los Angeles, CA",1313,55,1042,104,271,97
14000US06037301501,6037301501,"Census Tract 3015.01, Los Angeles, CA",554,42,412,68,142,60
14000US06037301502,6037301502,"Census Tract 3015.02, Los Angeles, CA",2459,101,197,98,2262,121
14000US06037301601,6037301601,"Census Tract 3016.01, Los Angeles, CA",2373,35,259,113,2114,124
14000US06037301602,6037301602,"Census Tract 3016.02, Los Angeles, CA",1608,84,345,89,1263,103
14000US06037301701,6037301701,"Census Tract 3017.01, Los Angeles, CA",1140,50,494,79,646,73
14000US06037301702,6037301702,"Census Tract 3017.02, Los Angeles, CA",2064,71,309,94,1755,119
14000US06037301801,6037301801,"Census Tract 3018.01, Los Angeles, CA",2264,97,296,90,1968,112
14000US06037301802,6037301802,"Census Tract 3018.02, Los Angeles, CA",1923,89,310,103,1613,142
14000US06037301900,6037301900,"Census Tract 3019, Los Angeles, CA",3243,135,1016,193,2227,215
14000US06037302002,6037302002,"Census Tract 3020.02, Los Angeles, CA",1722,81,314,93,1408,107
14000US06037302003,6037302003,"Census Tract 3020.03, Los Angeles, CA",1404,58,104,56,1300,81
14000US06037302004,6037302004,"Census Tract 3020.04, Los Angeles, CA",1603,93,248,80,1355,99
14000US06037302102,6037302102,"Census Tract 3021.02, Los Angeles, CA",2498,145,853,161,1645,211
14000US06037302103,6037302103,"Census Tract 3021.03, Los Angeles, CA",1932,90,215,77,1717,108
14000US06037302104,6037302104,"Census Tract 3021.04, Los Angeles, CA",1509,60,159,59,1350,81
14000US06037302201,6037302201,"Census Tract 3022.01, Los Angeles, CA",1875,83,99,46,1776,93
14000US06037302202,6037302202,"Census Tract 3022.02, Los Angeles, CA",1988,43,221,72,1767,81
14000US06037302301,6037302301,"Census Tract 3023.01, Los Angeles, CA",1403,88,328,94,1075,96
14000US06037302302,6037302302,"Census Tract 3023.02, Los Angeles, CA",1962,72,94,48,1868,90
14000US06037302401,6037302401,"Census Tract 3024.01, Los Angeles, CA",2470,95,218,112,2252,154
14000US06037302503,6037302503,"Census Tract 3025.03, Los Angeles, CA",1392,83,117,46,1275,100
14000US06037302504,6037302504,"Census Tract 3025.04, Los Angeles, CA",1500,44,196,63,1304,70
14000US06037302505,6037302505,"Census Tract 3025.05, Los Angeles, CA",1520,77,48,41,1472,83
14000US06037302506,6037302506,"Census Tract 3025.06, Los Angeles, CA",1361,58,331,83,1030,108
14000US06037310100,6037310100,"Census Tract 3101, Los Angeles, CA",1958,120,1735,147,223,108
14000US06037310201,6037310201,"Census Tract 3102.01, Los Angeles, CA",2079,57,1033,172,1046,182
14000US06037310202,6037310202,"Census Tract 3102.02, Los Angeles, CA",1837,71,646,99,1191,119
14000US06037310300,6037310300,"Census Tract 3103, Los Angeles, CA",1052,42,929,64,123,62
14000US06037310400,6037310400,"Census Tract 3104, Los Angeles, CA",1242,75,745,117,497,100
14000US06037310501,6037310501,"Census Tract 3105.01, Los Angeles, CA",1343,69,269,74,1074,90
14000US06037310601,6037310601,"Census Tract 3106.01, Los Angeles, CA",2362,104,725,159,1637,178
14000US06037310602,6037310602,"Census Tract 3106.02, Los Angeles, CA",1053,75,447,72,606,85
14000US06037310701,6037310701,"Census Tract 3107.01, Los Angeles, CA",1101,54,78,38,1023,60
14000US06037310702,6037310702,"Census Tract 3107.02, Los Angeles, CA",3486,159,338,112,3148,190
14000US06037310703,6037310703,"Census Tract 3107.03, Los Angeles, CA",2041,107,247,85,1794,131
14000US06037310800,6037310800,"Census Tract 3108, Los Angeles, CA",1978,84,982,122,996,128
14000US06037310900,6037310900,"Census Tract 3109, Los Angeles, CA",2411,159,1578,186,833,182
14000US06037311000,6037311000,"Census Tract 3110, Los Angeles, CA",1386,69,847,102,539,108
14000US06037311100,6037311100,"Census Tract 3111, Los Angeles, CA",1379,38,1109,87,270,88
14000US06037311200,6037311200,"Census Tract 3112, Los Angeles, CA",1299,52,569,78,730,104
14000US06037311300,6037311300,"Census Tract 3113, Los Angeles, CA",1506,63,1028,106,478,109
14000US06037311400,6037311400,"Census Tract 3114, Los Angeles, CA",974,51,641,73,333,73
14000US06037311500,6037311500,"Census Tract 3115, Los Angeles, CA",2374,111,1056,150,1318,195
14000US06037311600,6037311600,"Census Tract 3116, Los Angeles, CA",3609,199,693,126,2916,208
14000US06037311700,6037311700,"Census Tract 3117, Los Angeles, CA",2551,129,1297,196,1254,209
14000US06037311801,6037311801,"Census Tract 3118.01, Los Angeles, CA",1304,80,305,94,999,106
14000US06037311802,6037311802,"Census Tract 3118.02, Los Angeles, CA",1472,70,199,51,1273,83
14000US06037320000,6037320000,"Census Tract 3200, Los Angeles, CA",0,12,0,12,0,12
14000US06037320100,6037320100,"Census Tract 3201, Los Angeles, CA",1886,123,1372,138,514,132
14000US06037320201,6037320201,"Census Tract 3202.01, Los Angeles, CA",1308,108,253,79,1055,128
14000US06037320202,6037320202,"Census Tract 3202.02, Los Angeles, CA",1442,111,968,147,474,134
14000US06037320300,6037320300,"Census Tract 3203, Los Angeles, CA",1933,131,954,146,979,150
14000US06037400204,6037400204,"Census Tract 4002.04, Los Angeles, CA",2098,109,2032,122,66,62
14000US06037400205,6037400205,"Census Tract 4002.05, Los Angeles, CA",927,80,901,78,26,23
14000US06037400206,6037400206,"Census Tract 4002.06, Los Angeles, CA",1753,81,1596,100,157,70
14000US06037400207,6037400207,"Census Tract 4002.07, Los Angeles, CA",1468,83,1366,89,102,49
14000US06037400302,6037400302,"Census Tract 4003.02, Los Angeles, CA",1133,57,681,95,452,104
14000US06037400304,6037400304,"Census Tract 4003.04, Los Angeles, CA",2565,173,1244,172,1321,216
14000US06037400402,6037400402,"Census Tract 4004.02, Los Angeles, CA",1356,71,1032,107,324,91
14000US06037400403,6037400403,"Census Tract 4004.03, Los Angeles, CA",1292,56,893,91,399,89
14000US06037400404,6037400404,"Census Tract 4004.04, Los Angeles, CA",1403,75,1317,85,86,47
14000US06037400501,6037400501,"Census Tract 4005.01, Los Angeles, CA",661,37,619,48,42,30
14000US06037400602,6037400602,"Census Tract 4006.02, Los Angeles, CA",1289,84,666,107,623,124
14000US06037400603,6037400603,"Census Tract 4006.03, Los Angeles, CA",1727,107,1108,135,619,123
14000US06037400604,6037400604,"Census Tract 4006.04, Los Angeles, CA",1224,98,818,87,406,75
14000US06037400800,6037400800,"Census Tract 4008, Los Angeles, CA",1120,82,933,85,187,60
14000US06037400900,6037400900,"Census Tract 4009, Los Angeles, CA",1525,74,1063,107,462,111
14000US06037401001,6037401001,"Census Tract 4010.01, Los Angeles, CA",1013,28,850,58,163,55
14000US06037401002,6037401002,"Census Tract 4010.02, Los Angeles, CA",1484,109,625,118,859,140
14000US06037401101,6037401101,"Census Tract 4011.01, Los Angeles, CA",1997,78,811,167,1186,177
14000US06037401102,6037401102,"Census Tract 4011.02, Los Angeles, CA",1234,95,537,112,697,127
14000US06037401201,6037401201,"Census Tract 4012.01, Los Angeles, CA",1007,61,854,72,153,57
14000US06037401202,6037401202,"Census Tract 4012.02, Los Angeles, CA",1373,46,1169,87,204,86
14000US06037401203,6037401203,"Census Tract 4012.03, Los Angeles, CA",1681,52,1293,106,388,91
14000US06037401303,6037401303,"Census Tract 4013.03, Los Angeles, CA",701,56,613,65,88,49
14000US06037401304,6037401304,"Census Tract 4013.04, Los Angeles, CA",1848,115,1669,143,179,109
14000US06037401311,6037401311,"Census Tract 4013.11, Los Angeles, CA",2124,142,1433,196,691,190
14000US06037401312,6037401312,"Census Tract 4013.12, Los Angeles, CA",1909,88,1495,155,414,143
14000US06037401500,6037401500,"Census Tract 4015, Los Angeles, CA",1898,78,1274,120,624,117
14000US06037401601,6037401601,"Census Tract 4016.01, Los Angeles, CA",2247,116,1713,137,534,128
14000US06037401602,6037401602,"Census Tract 4016.02, Los Angeles, CA",2035,79,1106,116,929,116
14000US06037401603,6037401603,"Census Tract 4016.03, Los Angeles, CA",1300,52,926,94,374,96
14000US06037401701,6037401701,"Census Tract 4017.01, Los Angeles, CA",1671,68,1246,120,425,107
14000US06037401703,6037401703,"Census Tract 4017.03, Los Angeles, CA",1433,83,626,105,807,121
14000US06037401704,6037401704,"Census Tract 4017.04, Los Angeles, CA",2117,80,1161,140,956,146
14000US06037401800,6037401800,"Census Tract 4018, Los Angeles, CA",2760,149,2117,196,643,191
14000US06037401901,6037401901,"Census Tract 4019.01, Los Angeles, CA",127,38,8,9,119,39
14000US06037401902,6037401902,"Census Tract 4019.02, Los Angeles, CA",2676,147,1111,177,1565,177
14000US06037402001,6037402001,"Census Tract 4020.01, Los Angeles, CA",1124,49,495,123,629,124
14000US06037402002,6037402002,"Census Tract 4020.02, Los Angeles, CA",1575,80,669,110,906,118
14000US06037402101,6037402101,"Census Tract 4021.01, Los Angeles, CA",1053,37,702,97,351,95
14000US06037402102,6037402102,"Census Tract 4021.02, Los Angeles, CA",1216,55,794,101,422,108
14000US06037402200,6037402200,"Census Tract 4022, Los Angeles, CA",2011,94,1440,145,571,149
14000US06037402301,6037402301,"Census Tract 4023.01, Los Angeles, CA",1318,42,616,99,702,104
14000US06037402303,6037402303,"Census Tract 4023.03, Los Angeles, CA",1096,44,396,72,700,78
14000US06037402304,6037402304,"Census Tract 4023.04, Los Angeles, CA",938,41,298,63,640,66
14000US06037402402,6037402402,"Census Tract 4024.02, Los Angeles, CA",1886,126,862,164,1024,181
14000US06037402403,6037402403,"Census Tract 4024.03, Los Angeles, CA",947,72,800,88,147,69
14000US06037402404,6037402404,"Census Tract 4024.04, Los Angeles, CA",5,7,0,12,5,7
14000US06037402405,6037402405,"Census Tract 4024.05, Los Angeles, CA",646,37,491,66,155,55
14000US06037402406,6037402406,"Census Tract 4024.06, Los Angeles, CA",1182,56,604,97,578,101
14000US06037402501,6037402501,"Census Tract 4025.01, Los Angeles, CA",1310,70,355,87,955,107
14000US06037402502,6037402502,"Census Tract 4025.02, Los Angeles, CA",1783,47,522,106,1261,111
14000US06037402600,6037402600,"Census Tract 4026, Los Angeles, CA",2342,99,1169,154,1173,163
14000US06037402702,6037402702,"Census Tract 4027.02, Los Angeles, CA",1565,74,336,93,1229,101
14000US06037402703,6037402703,"Census Tract 4027.03, Los Angeles, CA",1281,51,813,115,468,114
14000US06037402705,6037402705,"Census Tract 4027.05, Los Angeles, CA",840,29,693,53,147,45
14000US06037402706,6037402706,"Census Tract 4027.06, Los Angeles, CA",970,37,611,90,359,84
14000US06037402801,6037402801,"Census Tract 4028.01, Los Angeles, CA",1126,67,401,92,725,101
14000US06037402803,6037402803,"Census Tract 4028.03, Los Angeles, CA",725,38,296,65,429,65
14000US06037402804,6037402804,"Census Tract 4028.04, Los Angeles, CA",936,42,220,47,716,56
14000US06037402902,6037402902,"Census Tract 4029.02, Los Angeles, CA",1531,46,731,95,800,95
14000US06037402903,6037402903,"Census Tract 4029.03, Los Angeles, CA",982,40,545,81,437,88
14000US06037402904,6037402904,"Census Tract 4029.04, Los Angeles, CA",793,33,618,70,175,58
14000US06037403000,6037403000,"Census Tract 4030, Los Angeles, CA",1516,31,1153,102,363,96
14000US06037403200,6037403200,"Census Tract 4032, Los Angeles, CA",0,12,0,12,0,12
14000US06037403303,6037403303,"Census Tract 4033.03, Los Angeles, CA",721,66,557,84,164,74
14000US06037403304,6037403304,"Census Tract 4033.04, Los Angeles, CA",1648,103,1402,109,246,104
14000US06037403305,6037403305,"Census Tract 4033.05, Los Angeles, CA",697,33,508,71,189,65
14000US06037403312,6037403312,"Census Tract 4033.12, Los Angeles, CA",1602,54,1236,98,366,86
14000US06037403316,6037403316,"Census Tract 4033.16, Los Angeles, CA",2385,114,1758,132,627,130
14000US06037403317,6037403317,"Census Tract 4033.17, Los Angeles, CA",1427,37,1232,89,195,85
14000US06037403318,6037403318,"Census Tract 4033.18, Los Angeles, CA",1928,70,1472,116,456,109
14000US06037403319,6037403319,"Census Tract 4033.19, Los Angeles, CA",1594,83,1045,116,549,117
14000US06037403320,6037403320,"Census Tract 4033.20, Los Angeles, CA",1572,97,1326,92,246,89
14000US06037403321,6037403321,"Census Tract 4033.21, Los Angeles, CA",1937,64,1435,138,502,144
14000US06037403322,6037403322,"Census Tract 4033.22, Los Angeles, CA",1221,54,920,100,301,85
14000US06037403323,6037403323,"Census Tract 4033.23, Los Angeles, CA",1758,69,1245,133,513,127
14000US06037403324,6037403324,"Census Tract 4033.24, Los Angeles, CA",2115,107,1656,136,459,123
14000US06037403325,6037403325,"Census Tract 4033.25, Los Angeles, CA",1689,48,1303,148,386,130
14000US06037403401,6037403401,"Census Tract 4034.01, Los Angeles, CA",1585,90,1271,115,314,104
14000US06037403402,6037403402,"Census Tract 4034.02, Los Angeles, CA",1077,58,867,70,210,66
14000US06037403403,6037403403,"Census Tract 4034.03, Los Angeles, CA",1547,76,1374,95,173,72
14000US06037403404,6037403404,"Census Tract 4034.04, Los Angeles, CA",764,42,691,51,73,30
14000US06037403405,6037403405,"Census Tract 4034.05, Los Angeles, CA",533,24,454,34,79,26
14000US06037403406,6037403406,"Census Tract 4034.06, Los Angeles, CA",886,43,583,65,303,62
14000US06037403407,6037403407,"Census Tract 4034.07, Los Angeles, CA",702,65,671,66,31,25
14000US06037403408,6037403408,"Census Tract 4034.08, Los Angeles, CA",1975,94,1785,123,190,95
14000US06037403500,6037403500,"Census Tract 4035, Los Angeles, CA",554,43,402,54,152,51
14000US06037403600,6037403600,"Census Tract 4036, Los Angeles, CA",2093,142,1542,152,551,189
14000US06037403702,6037403702,"Census Tract 4037.02, Los Angeles, CA",1109,67,967,100,142,76
14000US06037403703,6037403703,"Census Tract 4037.03, Los Angeles, CA",1531,69,1185,119,346,108
14000US06037403721,6037403721,"Census Tract 4037.21, Los Angeles, CA",1606,79,905,134,701,135
14000US06037403722,6037403722,"Census Tract 4037.22, Los Angeles, CA",1728,78,686,97,1042,98
14000US06037403801,6037403801,"Census Tract 4038.01, Los Angeles, CA",1925,84,1214,129,711,132
14000US06037403802,6037403802,"Census Tract 4038.02, Los Angeles, CA",1918,99,1025,126,893,132
14000US06037403901,6037403901,"Census Tract 4039.01, Los Angeles, CA",911,42,704,71,207,64
14000US06037403902,6037403902,"Census Tract 4039.02, Los Angeles, CA",1494,61,1008,123,486,116
14000US06037404000,6037404000,"Census Tract 4040, Los Angeles, CA",1299,66,787,92,512,113
14000US06037404100,6037404100,"Census Tract 4041, Los Angeles, CA",1458,48,947,94,511,94
14000US06037404201,6037404201,"Census Tract 4042.01, Los Angeles, CA",987,68,552,85,435,88
14000US06037404202,6037404202,"Census Tract 4042.02, Los Angeles, CA",731,49,391,57,340,56
14000US06037404301,6037404301,"Census Tract 4043.01, Los Angeles, CA",1386,80,435,85,951,92
14000US06037404302,6037404302,"Census Tract 4043.02, Los Angeles, CA",572,21,351,48,221,49
14000US06037404401,6037404401,"Census Tract 4044.01, Los Angeles, CA",966,46,607,76,359,64
14000US06037404402,6037404402,"Census Tract 4044.02, Los Angeles, CA",1102,76,558,121,544,120
14000US06037404501,6037404501,"Census Tract 4045.01, Los Angeles, CA",671,29,369,62,302,64
14000US06037404503,6037404503,"Census Tract 4045.03, Los Angeles, CA",711,51,525,60,186,46
14000US06037404504,6037404504,"Census Tract 4045.04, Los Angeles, CA",1296,77,540,103,756,95
14000US06037404600,6037404600,"Census Tract 4046, Los Angeles, CA",392,24,282,28,110,28
14000US06037404701,6037404701,"Census Tract 4047.01, Los Angeles, CA",1238,90,782,110,456,114
14000US06037404702,6037404702,"Census Tract 4047.02, Los Angeles, CA",1400,67,701,116,699,107
14000US06037404703,6037404703,"Census Tract 4047.03, Los Angeles, CA",756,52,298,58,458,62
14000US06037404801,6037404801,"Census Tract 4048.01, Los Angeles, CA",1879,70,848,118,1031,132
14000US06037404802,6037404802,"Census Tract 4048.02, Los Angeles, CA",1059,73,443,97,616,105
14000US06037404803,6037404803,"Census Tract 4048.03, Los Angeles, CA",445,28,277,55,168,50
14000US06037404901,6037404901,"Census Tract 4049.01, Los Angeles, CA",1289,70,844,111,445,121
14000US06037404902,6037404902,"Census Tract 4049.02, Los Angeles, CA",959,30,705,70,254,67
14000US06037404903,6037404903,"Census Tract 4049.03, Los Angeles, CA",699,35,437,68,262,69
14000US06037405001,6037405001,"Census Tract 4050.01, Los Angeles, CA",1357,60,1047,109,310,102
14000US06037405002,6037405002,"Census Tract 4050.02, Los Angeles, CA",682,37,464,56,218,53
14000US06037405101,6037405101,"Census Tract 4051.01, Los Angeles, CA",1160,72,743,111,417,115
14000US06037405102,6037405102,"Census Tract 4051.02, Los Angeles, CA",1364,80,690,113,674,119
14000US06037405201,6037405201,"Census Tract 4052.01, Los Angeles, CA",1348,71,715,100,633,103
14000US06037405202,6037405202,"Census Tract 4052.02, Los Angeles, CA",1212,71,609,99,603,103
14000US06037405203,6037405203,"Census Tract 4052.03, Los Angeles, CA",795,47,572,78,223,66
14000US06037405301,6037405301,"Census Tract 4053.01, Los Angeles, CA",1019,42,507,90,512,91
14000US06037405302,6037405302,"Census Tract 4053.02, Los Angeles, CA",1488,55,853,106,635,106
14000US06037405400,6037405400,"Census Tract 4054, Los Angeles, CA",1263,81,1105,105,158,88
14000US06037405500,6037405500,"Census Tract 4055, Los Angeles, CA",1844,55,1312,146,532,143
14000US06037405600,6037405600,"Census Tract 4056, Los Angeles, CA",1603,58,1149,100,454,102
14000US06037405701,6037405701,"Census Tract 4057.01, Los Angeles, CA",1115,32,832,106,283,99
14000US06037405702,6037405702,"Census Tract 4057.02, Los Angeles, CA",1481,83,1088,126,393,116
14000US06037405800,6037405800,"Census Tract 4058, Los Angeles, CA",1641,69,1017,118,624,119
14000US06037405900,6037405900,"Census Tract 4059, Los Angeles, CA",1190,58,799,92,391,81
14000US06037406000,6037406000,"Census Tract 4060, Los Angeles, CA",1507,74,1006,107,501,117
14000US06037406101,6037406101,"Census Tract 4061.01, Los Angeles, CA",1206,71,475,90,731,108
14000US06037406102,6037406102,"Census Tract 4061.02, Los Angeles, CA",2158,126,411,111,1747,157
14000US06037406200,6037406200,"Census Tract 4062, Los Angeles, CA",1888,50,720,91,1168,96
14000US06037406300,6037406300,"Census Tract 4063, Los Angeles, CA",1673,82,1190,110,483,126
14000US06037406402,6037406402,"Census Tract 4064.02, Los Angeles, CA",563,41,531,47,32,19
14000US06037406411,6037406411,"Census Tract 4064.11, Los Angeles, CA",513,19,363,56,150,55
14000US06037406412,6037406412,"Census Tract 4064.12, Los Angeles, CA",748,33,649,54,99,47
14000US06037406500,6037406500,"Census Tract 4065, Los Angeles, CA",1870,93,1179,143,691,122
14000US06037406601,6037406601,"Census Tract 4066.01, Los Angeles, CA",1391,54,1185,121,206,108
14000US06037406602,6037406602,"Census Tract 4066.02, Los Angeles, CA",1276,26,905,97,371,96
14000US06037406701,6037406701,"Census Tract 4067.01, Los Angeles, CA",869,39,537,52,332,49
14000US06037406702,6037406702,"Census Tract 4067.02, Los Angeles, CA",1775,85,853,99,922,114
14000US06037406800,6037406800,"Census Tract 4068, Los Angeles, CA",1277,48,1075,77,202,86
14000US06037406901,6037406901,"Census Tract 4069.01, Los Angeles, CA",1151,71,693,89,458,97
14000US06037406902,6037406902,"Census Tract 4069.02, Los Angeles, CA",862,32,623,63,239,65
14000US06037407001,6037407001,"Census Tract 4070.01, Los Angeles, CA",1259,24,978,78,281,73
14000US06037407002,6037407002,"Census Tract 4070.02, Los Angeles, CA",747,40,641,52,106,43
14000US06037407101,6037407101,"Census Tract 4071.01, Los Angeles, CA",1167,34,665,90,502,90
14000US06037407102,6037407102,"Census Tract 4071.02, Los Angeles, CA",1230,61,876,97,354,87
14000US06037407200,6037407200,"Census Tract 4072, Los Angeles, CA",1589,64,1107,122,482,124
14000US06037407301,6037407301,"Census Tract 4073.01, Los Angeles, CA",1073,37,804,85,269,89
14000US06037407302,6037407302,"Census Tract 4073.02, Los Angeles, CA",768,17,665,47,103,48
14000US06037407400,6037407400,"Census Tract 4074, Los Angeles, CA",525,25,404,71,121,66
14000US06037407501,6037407501,"Census Tract 4075.01, Los Angeles, CA",1025,38,577,68,448,66
14000US06037407502,6037407502,"Census Tract 4075.02, Los Angeles, CA",859,49,580,77,279,68
14000US06037407601,6037407601,"Census Tract 4076.01, Los Angeles, CA",1116,71,424,89,692,90
14000US06037407602,6037407602,"Census Tract 4076.02, Los Angeles, CA",937,41,648,63,289,62
14000US06037407701,6037407701,"Census Tract 4077.01, Los Angeles, CA",1159,67,444,89,715,104
14000US06037407702,6037407702,"Census Tract 4077.02, Los Angeles, CA",1611,61,1146,115,465,108
14000US06037407801,6037407801,"Census Tract 4078.01, Los Angeles, CA",1085,43,856,96,229,94
14000US06037407802,6037407802,"Census Tract 4078.02, Los Angeles, CA",774,40,591,68,183,63
14000US06037407900,6037407900,"Census Tract 4079, Los Angeles, CA",1530,22,1133,101,397,97
14000US06037408003,6037408003,"Census Tract 4080.03, Los Angeles, CA",1276,27,973,113,303,110
14000US06037408004,6037408004,"Census Tract 4080.04, Los Angeles, CA",839,43,430,71,409,74
14000US06037408005,6037408005,"Census Tract 4080.05, Los Angeles, CA",1587,55,1126,91,461,99
14000US06037408006,6037408006,"Census Tract 4080.06, Los Angeles, CA",966,59,463,66,503,79
14000US06037408133,6037408133,"Census Tract 4081.33, Los Angeles, CA",1520,69,633,81,887,95
14000US06037408134,6037408134,"Census Tract 4081.34, Los Angeles, CA",767,40,591,68,176,60
14000US06037408135,6037408135,"Census Tract 4081.35, Los Angeles, CA",1164,45,627,98,537,96
14000US06037408136,6037408136,"Census Tract 4081.36, Los Angeles, CA",1004,42,793,89,211,82
14000US06037408137,6037408137,"Census Tract 4081.37, Los Angeles, CA",1334,63,495,85,839,102
14000US06037408138,6037408138,"Census Tract 4081.38, Los Angeles, CA",1207,83,873,109,334,109
14000US06037408139,6037408139,"Census Tract 4081.39, Los Angeles, CA",835,32,612,69,223,68
14000US06037408140,6037408140,"Census Tract 4081.40, Los Angeles, CA",760,31,580,69,180,69
14000US06037408141,6037408141,"Census Tract 4081.41, Los Angeles, CA",1112,56,837,114,275,114
14000US06037408202,6037408202,"Census Tract 4082.02, Los Angeles, CA",469,36,258,52,211,50
14000US06037408211,6037408211,"Census Tract 4082.11, Los Angeles, CA",1800,74,920,122,880,104
14000US06037408212,6037408212,"Census Tract 4082.12, Los Angeles, CA",1378,19,1088,102,290,102
14000US06037408301,6037408301,"Census Tract 4083.01, Los Angeles, CA",1239,56,799,106,440,106
14000US06037408302,6037408302,"Census Tract 4083.02, Los Angeles, CA",1070,66,913,91,157,63
14000US06037408303,6037408303,"Census Tract 4083.03, Los Angeles, CA",1185,49,1026,80,159,83
14000US06037408401,6037408401,"Census Tract 4084.01, Los Angeles, CA",1237,55,730,98,507,95
14000US06037408402,6037408402,"Census Tract 4084.02, Los Angeles, CA",1886,27,1759,74,127,72
14000US06037408501,6037408501,"Census Tract 4085.01, Los Angeles, CA",806,38,511,70,295,67
14000US06037408503,6037408503,"Census Tract 4085.03, Los Angeles, CA",1973,59,1774,112,199,101
14000US06037408504,6037408504,"Census Tract 4085.04, Los Angeles, CA",1583,66,877,108,706,107
14000US06037408505,6037408505,"Census Tract 4085.05, Los Angeles, CA",769,37,629,68,140,63
14000US06037408623,6037408623,"Census Tract 4086.23, Los Angeles, CA",970,55,652,73,318,65
14000US06037408624,6037408624,"Census Tract 4086.24, Los Angeles, CA",962,68,806,86,156,62
14000US06037408625,6037408625,"Census Tract 4086.25, Los Angeles, CA",1324,66,1002,113,322,101
14000US06037408626,6037408626,"Census Tract 4086.26, Los Angeles, CA",1328,111,790,127,538,130
14000US06037408627,6037408627,"Census Tract 4086.27, Los Angeles, CA",922,32,796,65,126,56
14000US06037408628,6037408628,"Census Tract 4086.28, Los Angeles, CA",1866,86,1283,137,583,132
14000US06037408629,6037408629,"Census Tract 4086.29, Los Angeles, CA",926,55,783,61,143,44
14000US06037408630,6037408630,"Census Tract 4086.30, Los Angeles, CA",534,44,384,71,150,60
14000US06037408631,6037408631,"Census Tract 4086.31, Los Angeles, CA",1366,52,969,98,397,84
14000US06037408703,6037408703,"Census Tract 4087.03, Los Angeles, CA",1928,79,1670,115,258,102
14000US06037408704,6037408704,"Census Tract 4087.04, Los Angeles, CA",1042,71,516,100,526,108
14000US06037408705,6037408705,"Census Tract 4087.05, Los Angeles, CA",1597,43,1125,135,472,124
14000US06037408706,6037408706,"Census Tract 4087.06, Los Angeles, CA",477,43,432,58,45,35
14000US06037408722,6037408722,"Census Tract 4087.22, Los Angeles, CA",1174,81,867,123,307,112
14000US06037408723,6037408723,"Census Tract 4087.23, Los Angeles, CA",818,21,563,58,255,59
14000US06037408724,6037408724,"Census Tract 4087.24, Los Angeles, CA",1552,41,30,29,1522,51
14000US06037408800,6037408800,"Census Tract 4088, Los Angeles, CA",1461,100,290,65,1171,109
14000US06037430002,6037430002,"Census Tract 4300.02, Los Angeles, CA",2409,143,1475,194,934,195
14000US06037430003,6037430003,"Census Tract 4300.03, Los Angeles, CA",1607,83,1519,94,88,47
14000US06037430101,6037430101,"Census Tract 4301.01, Los Angeles, CA",1907,100,724,96,1183,129
14000US06037430102,6037430102,"Census Tract 4301.02, Los Angeles, CA",1209,73,780,113,429,108
14000US06037430200,6037430200,"Census Tract 4302, Los Angeles, CA",393,46,228,34,165,37
14000US06037430301,6037430301,"Census Tract 4303.01, Los Angeles, CA",1511,82,1276,91,235,72
14000US06037430302,6037430302,"Census Tract 4303.02, Los Angeles, CA",2183,100,1431,146,752,159
14000US06037430400,6037430400,"Census Tract 4304, Los Angeles, CA",1464,99,1147,101,317,104
14000US06037430501,6037430501,"Census Tract 4305.01, Los Angeles, CA",1666,127,1348,137,318,111
14000US06037430502,6037430502,"Census Tract 4305.02, Los Angeles, CA",2998,177,1530,203,1468,221
14000US06037430600,6037430600,"Census Tract 4306, Los Angeles, CA",1433,116,1229,120,204,89
14000US06037430701,6037430701,"Census Tract 4307.01, Los Angeles, CA",1912,105,1203,121,709,108
14000US06037430721,6037430721,"Census Tract 4307.21, Los Angeles, CA",1322,77,628,106,694,122
14000US06037430723,6037430723,"Census Tract 4307.23, Los Angeles, CA",1629,135,579,109,1050,143
14000US06037430724,6037430724,"Census Tract 4307.24, Los Angeles, CA",1895,173,428,109,1467,184
14000US06037430801,6037430801,"Census Tract 4308.01, Los Angeles, CA",2350,163,1052,238,1298,260
14000US06037430802,6037430802,"Census Tract 4308.02, Los Angeles, CA",1352,84,1019,126,333,117
14000US06037430803,6037430803,"Census Tract 4308.03, Los Angeles, CA",1819,103,1382,132,437,114
14000US06037430901,6037430901,"Census Tract 4309.01, Los Angeles, CA",1569,67,511,87,1058,96
14000US06037430902,6037430902,"Census Tract 4309.02, Los Angeles, CA",1536,98,513,92,1023,116
14000US06037431001,6037431001,"Census Tract 4310.01, Los Angeles, CA",2649,151,869,181,1780,212
14000US06037431002,6037431002,"Census Tract 4310.02, Los Angeles, CA",1240,72,640,98,600,99
14000US06037431100,6037431100,"Census Tract 4311, Los Angeles, CA",2076,114,747,158,1329,180
14000US06037431200,6037431200,"Census Tract 4312, Los Angeles, CA",1490,73,973,117,517,107
14000US06037431300,6037431300,"Census Tract 4313, Los Angeles, CA",850,49,641,69,209,60
14000US06037431400,6037431400,"Census Tract 4314, Los Angeles, CA",1312,99,942,153,370,125
14000US06037431501,6037431501,"Census Tract 4315.01, Los Angeles, CA",1666,83,981,116,685,112
14000US06037431502,6037431502,"Census Tract 4315.02, Los Angeles, CA",1407,92,837,121,570,143
14000US06037431600,6037431600,"Census Tract 4316, Los Angeles, CA",1299,85,1003,108,296,88
14000US06037431700,6037431700,"Census Tract 4317, Los Angeles, CA",2046,152,1540,178,506,154
14000US06037431800,6037431800,"Census Tract 4318, Los Angeles, CA",1853,131,1009,162,844,180
14000US06037431900,6037431900,"Census Tract 4319, Los Angeles, CA",1458,77,604,121,854,141
14000US06037432000,6037432000,"Census Tract 4320, Los Angeles, CA",2405,127,1366,174,1039,206
14000US06037432101,6037432101,"Census Tract 4321.01, Los Angeles, CA",1359,79,1023,105,336,94
14000US06037432102,6037432102,"Census Tract 4321.02, Los Angeles, CA",1713,83,1309,108,404,106
14000US06037432201,6037432201,"Census Tract 4322.01, Los Angeles, CA",1228,86,708,104,520,109
14000US06037432202,6037432202,"Census Tract 4322.02, Los Angeles, CA",1164,82,680,105,484,100
14000US06037432300,6037432300,"Census Tract 4323, Los Angeles, CA",1160,61,639,99,521,108
14000US06037432401,6037432401,"Census Tract 4324.01, Los Angeles, CA",1008,46,413,64,595,70
14000US06037432402,6037432402,"Census Tract 4324.02, Los Angeles, CA",1647,120,715,118,932,151
14000US06037432500,6037432500,"Census Tract 4325, Los Angeles, CA",2451,109,1363,196,1088,203
14000US06037432601,6037432601,"Census Tract 4326.01, Los Angeles, CA",1737,77,892,109,845,128
14000US06037432602,6037432602,"Census Tract 4326.02, Los Angeles, CA",1138,81,692,116,446,98
14000US06037432700,6037432700,"Census Tract 4327, Los Angeles, CA",1397,92,661,122,736,120
14000US06037432801,6037432801,"Census Tract 4328.01, Los Angeles, CA",937,55,222,65,715,74
14000US06037432802,6037432802,"Census Tract 4328.02, Los Angeles, CA",1396,103,210,58,1186,114
14000US06037432901,6037432901,"Census Tract 4329.01, Los Angeles, CA",1159,105,630,105,529,96
14000US06037432902,6037432902,"Census Tract 4329.02, Los Angeles, CA",861,64,617,76,244,78
14000US06037433101,6037433101,"Census Tract 4331.01, Los Angeles, CA",668,31,412,49,256,50
14000US06037433102,6037433102,"Census Tract 4331.02, Los Angeles, CA",1292,63,474,96,818,105
14000US06037433200,6037433200,"Census Tract 4332, Los Angeles, CA",1699,81,712,106,987,120
14000US06037433302,6037433302,"Census Tract 4333.02, Los Angeles, CA",418,37,112,32,306,48
14000US06037433304,6037433304,"Census Tract 4333.04, Los Angeles, CA",1315,91,195,82,1120,121
14000US06037433305,6037433305,"Census Tract 4333.05, Los Angeles, CA",1280,33,271,79,1009,85
14000US06037433306,6037433306,"Census Tract 4333.06, Los Angeles, CA",794,41,280,68,514,70
14000US06037433307,6037433307,"Census Tract 4333.07, Los Angeles, CA",880,28,375,59,505,57
14000US06037433401,6037433401,"Census Tract 4334.01, Los Angeles, CA",775,45,325,55,450,61
14000US06037433402,6037433402,"Census Tract 4334.02, Los Angeles, CA",1197,59,445,118,752,116
14000US06037433403,6037433403,"Census Tract 4334.03, Los Angeles, CA",1367,58,288,95,1079,113
14000US06037433501,6037433501,"Census Tract 4335.01, Los Angeles, CA",572,45,190,69,382,74
14000US06037433503,6037433503,"Census Tract 4335.03, Los Angeles, CA",723,45,263,58,460,54
14000US06037433504,6037433504,"Census Tract 4335.04, Los Angeles, CA",1025,83,234,84,791,104
14000US06037433601,6037433601,"Census Tract 4336.01, Los Angeles, CA",1287,63,661,126,626,114
14000US06037433602,6037433602,"Census Tract 4336.02, Los Angeles, CA",801,44,374,63,427,62
14000US06037433700,6037433700,"Census Tract 4337, Los Angeles, CA",889,53,563,83,326,76
14000US06037433801,6037433801,"Census Tract 4338.01, Los Angeles, CA",1415,81,497,94,918,100
14000US06037433802,6037433802,"Census Tract 4338.02, Los Angeles, CA",941,65,758,83,183,73
14000US06037433901,6037433901,"Census Tract 4339.01, Los Angeles, CA",1372,40,351,107,1021,114
14000US06037433902,6037433902,"Census Tract 4339.02, Los Angeles, CA",840,72,490,73,350,82
14000US06037434001,6037434001,"Census Tract 4340.01, Los Angeles, CA",986,68,684,82,302,81
14000US06037434003,6037434003,"Census Tract 4340.03, Los Angeles, CA",1032,44,400,67,632,75
14000US06037434004,6037434004,"Census Tract 4340.04, Los Angeles, CA",713,36,355,73,358,74
14000US06037460000,6037460000,"Census Tract 4600, Los Angeles, CA",1657,108,1435,123,222,80
14000US06037460100,6037460100,"Census Tract 4601, Los Angeles, CA",2368,136,2097,153,271,113
14000US06037460200,6037460200,"Census Tract 4602, Los Angeles, CA",2016,129,1578,154,438,139
14000US06037460301,6037460301,"Census Tract 4603.01, Los Angeles, CA",1606,88,1370,114,236,94
14000US06037460302,6037460302,"Census Tract 4603.02, Los Angeles, CA",1381,68,1000,102,381,100
14000US06037460401,6037460401,"Census Tract 4604.01, Los Angeles, CA",317,31,218,31,99,26
14000US06037460501,6037460501,"Census Tract 4605.01, Los Angeles, CA",1754,90,1657,93,97,49
14000US06037460502,6037460502,"Census Tract 4605.02, Los Angeles, CA",1338,75,1245,78,93,44
14000US06037460600,6037460600,"Census Tract 4606, Los Angeles, CA",1416,91,1317,83,99,56
14000US06037460700,6037460700,"Census Tract 4607, Los Angeles, CA",1559,70,1469,86,90,58
14000US06037460800,6037460800,"Census Tract 4608, Los Angeles, CA",1195,89,1144,98,51,49
14000US06037460900,6037460900,"Census Tract 4609, Los Angeles, CA",2002,86,1155,152,847,148
14000US06037461000,6037461000,"Census Tract 4610, Los Angeles, CA",1664,111,1145,133,519,123
14000US06037461100,6037461100,"Census Tract 4611, Los Angeles, CA",1837,101,973,134,864,152
14000US06037461200,6037461200,"Census Tract 4612, Los Angeles, CA",1663,79,1410,84,253,81
14000US06037461300,6037461300,"Census Tract 4613, Los Angeles, CA",2464,151,1396,226,1068,189
14000US06037461400,6037461400,"Census Tract 4614, Los Angeles, CA",1280,96,503,102,777,113
14000US06037461501,6037461501,"Census Tract 4615.01, Los Angeles, CA",1288,76,638,102,650,111
14000US06037461502,6037461502,"Census Tract 4615.02, Los Angeles, CA",1675,104,604,96,1071,121
14000US06037461600,6037461600,"Census Tract 4616, Los Angeles, CA",1786,79,704,116,1082,117
14000US06037461700,6037461700,"Census Tract 4617, Los Angeles, CA",659,43,545,53,114,39
14000US06037461901,6037461901,"Census Tract 4619.01, Los Angeles, CA",1670,91,234,85,1436,109
14000US06037461902,6037461902,"Census Tract 4619.02, Los Angeles, CA",1191,85,102,37,1089,91
14000US06037462001,6037462001,"Census Tract 4620.01, Los Angeles, CA",1154,71,276,84,878,92
14000US06037462002,6037462002,"Census Tract 4620.02, Los Angeles, CA",1162,70,243,72,919,88
14000US06037462100,6037462100,"Census Tract 4621, Los Angeles, CA",1862,52,661,102,1201,106
14000US06037462201,6037462201,"Census Tract 4622.01, Los Angeles, CA",1935,86,114,57,1821,106
14000US06037462202,6037462202,"Census Tract 4622.02, Los Angeles, CA",1351,129,204,67,1147,117
14000US06037462301,6037462301,"Census Tract 4623.01, Los Angeles, CA",1909,74,325,114,1584,126
14000US06037462302,6037462302,"Census Tract 4623.02, Los Angeles, CA",1525,77,300,78,1225,92
14000US06037462400,6037462400,"Census Tract 4624, Los Angeles, CA",1605,69,888,103,717,98
14000US06037462500,6037462500,"Census Tract 4625, Los Angeles, CA",2333,135,1289,190,1044,162
14000US06037462600,6037462600,"Census Tract 4626, Los Angeles, CA",845,48,697,61,148,52
14000US06037462700,6037462700,"Census Tract 4627, Los Angeles, CA",2118,169,748,127,1370,171
14000US06037462800,6037462800,"Census Tract 4628, Los Angeles, CA",1069,96,472,93,597,105
14000US06037462900,6037462900,"Census Tract 4629, Los Angeles, CA",1362,76,1056,103,306,101
14000US06037463000,6037463000,"Census Tract 4630, Los Angeles, CA",1049,69,690,75,359,75
14000US06037463101,6037463101,"Census Tract 4631.01, Los Angeles, CA",830,46,510,61,320,58
14000US06037463102,6037463102,"Census Tract 4631.02, Los Angeles, CA",1132,77,822,99,310,98
14000US06037463200,6037463200,"Census Tract 4632, Los Angeles, CA",1429,90,821,100,608,102
14000US06037463300,6037463300,"Census Tract 4633, Los Angeles, CA",919,48,501,60,418,69
14000US06037463400,6037463400,"Census Tract 4634, Los Angeles, CA",2521,185,1089,181,1432,182
14000US06037463500,6037463500,"Census Tract 4635, Los Angeles, CA",2568,221,782,170,1786,228
14000US06037463601,6037463601,"Census Tract 4636.01, Los Angeles, CA",3213,214,821,195,2392,268
14000US06037463602,6037463602,"Census Tract 4636.02, Los Angeles, CA",2887,210,419,109,2468,191
14000US06037463700,6037463700,"Census Tract 4637, Los Angeles, CA",1608,143,620,115,988,118
14000US06037463800,6037463800,"Census Tract 4638, Los Angeles, CA",1599,76,1381,102,218,85
14000US06037463900,6037463900,"Census Tract 4639, Los Angeles, CA",1529,109,832,113,697,118
14000US06037464000,6037464000,"Census Tract 4640, Los Angeles, CA",2521,167,1554,174,967,186
14000US06037464100,6037464100,"Census Tract 4641, Los Angeles, CA",2392,164,2087,200,305,138
14000US06037464200,6037464200,"Census Tract 4642, Los Angeles, CA",2095,139,1778,158,317,107
14000US06037480002,6037480002,"Census Tract 4800.02, Los Angeles, CA",1128,70,894,82,234,71
14000US06037480011,6037480011,"Census Tract 4800.11, Los Angeles, CA",1805,79,744,116,1061,121
14000US06037480012,6037480012,"Census Tract 4800.12, Los Angeles, CA",1649,83,963,117,686,118
14000US06037480101,6037480101,"Census Tract 4801.01, Los Angeles, CA",1217,78,708,104,509,100
14000US06037480102,6037480102,"Census Tract 4801.02, Los Angeles, CA",1453,72,874,102,579,109
14000US06037480201,6037480201,"Census Tract 4802.01, Los Angeles, CA",1245,98,1093,102,152,56
14000US06037480202,6037480202,"Census Tract 4802.02, Los Angeles, CA",844,58,640,71,204,59
14000US06037480302,6037480302,"Census Tract 4803.02, Los Angeles, CA",1820,61,698,106,1122,116
14000US06037480303,6037480303,"Census Tract 4803.03, Los Angeles, CA",1428,68,354,77,1074,78
14000US06037480304,6037480304,"Census Tract 4803.04, Los Angeles, CA",1895,76,233,75,1662,88
14000US06037480400,6037480400,"Census Tract 4804, Los Angeles, CA",2218,140,918,171,1300,189
14000US06037480500,6037480500,"Census Tract 4805, Los Angeles, CA",2033,110,1292,151,741,141
14000US06037480600,6037480600,"Census Tract 4806, Los Angeles, CA",3237,165,1046,156,2191,205
14000US06037480702,6037480702,"Census Tract 4807.02, Los Angeles, CA",1563,90,1073,103,490,84
14000US06037480703,6037480703,"Census Tract 4807.03, Los Angeles, CA",1208,72,648,90,560,98
14000US06037480704,6037480704,"Census Tract 4807.04, Los Angeles, CA",1786,101,600,95,1186,128
14000US06037480802,6037480802,"Census Tract 4808.02, Los Angeles, CA",1016,63,688,92,328,100
14000US06037480803,6037480803,"Census Tract 4808.03, Los Angeles, CA",1285,48,717,103,568,102
14000US06037480804,6037480804,"Census Tract 4808.04, Los Angeles, CA",1709,112,411,92,1298,134
14000US06037480901,6037480901,"Census Tract 4809.01, Los Angeles, CA",1675,69,432,78,1243,80
14000US06037480902,6037480902,"Census Tract 4809.02, Los Angeles, CA",1294,91,230,72,1064,89
14000US06037480903,6037480903,"Census Tract 4809.03, Los Angeles, CA",1003,44,367,62,636,65
14000US06037481001,6037481001,"Census Tract 4810.01, Los Angeles, CA",1578,86,568,119,1010,145
14000US06037481002,6037481002,"Census Tract 4810.02, Los Angeles, CA",2079,109,721,169,1358,185
14000US06037481101,6037481101,"Census Tract 4811.01, Los Angeles, CA",1468,84,305,86,1163,95
14000US06037481102,6037481102,"Census Tract 4811.02, Los Angeles, CA",1447,86,186,72,1261,104
14000US06037481103,6037481103,"Census Tract 4811.03, Los Angeles, CA",1465,114,729,106,736,141
14000US06037481201,6037481201,"Census Tract 4812.01, Los Angeles, CA",1204,71,501,84,703,100
14000US06037481202,6037481202,"Census Tract 4812.02, Los Angeles, CA",1936,131,880,114,1056,152
14000US06037481300,6037481300,"Census Tract 4813, Los Angeles, CA",842,49,569,64,273,54
14000US06037481401,6037481401,"Census Tract 4814.01, Los Angeles, CA",1833,92,728,105,1105,116
14000US06037481402,6037481402,"Census Tract 4814.02, Los Angeles, CA",1936,157,1014,194,922,200
14000US06037481500,6037481500,"Census Tract 4815, Los Angeles, CA",1531,73,1074,101,457,107
14000US06037481603,6037481603,"Census Tract 4816.03, Los Angeles, CA",1216,94,547,98,669,91
14000US06037481604,6037481604,"Census Tract 4816.04, Los Angeles, CA",1348,65,454,91,894,107
14000US06037481605,6037481605,"Census Tract 4816.05, Los Angeles, CA",1076,57,386,84,690,90
14000US06037481606,6037481606,"Census Tract 4816.06, Los Angeles, CA",1596,74,415,73,1181,105
14000US06037481711,6037481711,"Census Tract 4817.11, Los Angeles, CA",1383,98,333,87,1050,121
14000US06037481712,6037481712,"Census Tract 4817.12, Los Angeles, CA",1683,73,597,124,1086,129
14000US06037481713,6037481713,"Census Tract 4817.13, Los Angeles, CA",879,74,286,84,593,95
14000US06037481714,6037481714,"Census Tract 4817.14, Los Angeles, CA",908,48,250,53,658,60
14000US06037481800,6037481800,"Census Tract 4818, Los Angeles, CA",898,31,737,60,161,53
14000US06037481901,6037481901,"Census Tract 4819.01, Los Angeles, CA",1967,74,1377,152,590,138
14000US06037481902,6037481902,"Census Tract 4819.02, Los Angeles, CA",1139,91,571,90,568,93
14000US06037482001,6037482001,"Census Tract 4820.01, Los Angeles, CA",1029,50,806,78,223,74
14000US06037482002,6037482002,"Census Tract 4820.02, Los Angeles, CA",2500,136,1318,151,1182,174
14000US06037482101,6037482101,"Census Tract 4821.01, Los Angeles, CA",1484,77,809,96,675,107
14000US06037482102,6037482102,"Census Tract 4821.02, Los Angeles, CA",914,55,735,64,179,54
14000US06037482201,6037482201,"Census Tract 4822.01, Los Angeles, CA",1265,66,513,124,752,126
14000US06037482202,6037482202,"Census Tract 4822.02, Los Angeles, CA",1557,105,627,118,930,154
14000US06037482301,6037482301,"Census Tract 4823.01, Los Angeles, CA",1327,86,433,105,894,129
14000US06037482303,6037482303,"Census Tract 4823.03, Los Angeles, CA",1552,73,534,131,1018,134
14000US06037482304,6037482304,"Census Tract 4823.04, Los Angeles, CA",847,54,223,57,624,76
14000US06037482401,6037482401,"Census Tract 4824.01, Los Angeles, CA",973,49,399,70,574,73
14000US06037482402,6037482402,"Census Tract 4824.02, Los Angeles, CA",2239,52,1115,165,1124,157
14000US06037482502,6037482502,"Census Tract 4825.02, Los Angeles, CA",854,52,373,51,481,64
14000US06037482503,6037482503,"Census Tract 4825.03, Los Angeles, CA",1019,70,358,80,661,96
14000US06037482521,6037482521,"Census Tract 4825.21, Los Angeles, CA",1451,109,989,122,462,137
14000US06037482522,6037482522,"Census Tract 4825.22, Los Angeles, CA",1516,78,876,101,640,97
14000US06037482600,6037482600,"Census Tract 4826, Los Angeles, CA",2338,112,1509,161,829,188
14000US06037482701,6037482701,"Census Tract 4827.01, Los Angeles, CA",1325,91,823,122,502,121
14000US06037482702,6037482702,"Census Tract 4827.02, Los Angeles, CA",802,46,579,67,223,70
14000US06037482800,6037482800,"Census Tract 4828, Los Angeles, CA",1341,65,902,111,439,99
14000US06037500100,6037500100,"Census Tract 5001, Los Angeles, CA",1493,140,1252,138,241,79
14000US06037500201,6037500201,"Census Tract 5002.01, Los Angeles, CA",2209,92,1904,147,305,124
14000US06037500202,6037500202,"Census Tract 5002.02, Los Angeles, CA",1460,64,1293,81,167,69
14000US06037500300,6037500300,"Census Tract 5003, Los Angeles, CA",1087,44,991,67,96,63
14000US06037500402,6037500402,"Census Tract 5004.02, Los Angeles, CA",1190,73,524,92,666,112
14000US06037500403,6037500403,"Census Tract 5004.03, Los Angeles, CA",1067,42,954,90,113,86
14000US06037500404,6037500404,"Census Tract 5004.04, Los Angeles, CA",1343,44,1030,107,313,102
14000US06037500500,6037500500,"Census Tract 5005, Los Angeles, CA",894,48,610,79,284,72
14000US06037500600,6037500600,"Census Tract 5006, Los Angeles, CA",1282,76,1026,101,256,89
14000US06037500700,6037500700,"Census Tract 5007, Los Angeles, CA",1794,57,1311,118,483,106
14000US06037500800,6037500800,"Census Tract 5008, Los Angeles, CA",1344,79,1009,119,335,111
14000US06037500900,6037500900,"Census Tract 5009, Los Angeles, CA",1665,72,902,110,763,105
14000US06037501001,6037501001,"Census Tract 5010.01, Los Angeles, CA",769,34,475,75,294,74
14000US06037501002,6037501002,"Census Tract 5010.02, Los Angeles, CA",1450,21,1114,116,336,110
14000US06037501200,6037501200,"Census Tract 5012, Los Angeles, CA",1470,67,1009,109,461,94
14000US06037501300,6037501300,"Census Tract 5013, Los Angeles, CA",2388,95,1354,195,1034,191
14000US06037501400,6037501400,"Census Tract 5014, Los Angeles, CA",1236,59,407,93,829,103
14000US06037501501,6037501501,"Census Tract 5015.01, Los Angeles, CA",845,23,700,49,145,46
14000US06037501503,6037501503,"Census Tract 5015.03, Los Angeles, CA",1864,105,467,88,1397,123
14000US06037501504,6037501504,"Census Tract 5015.04, Los Angeles, CA",1469,77,114,55,1355,87
14000US06037501600,6037501600,"Census Tract 5016, Los Angeles, CA",2275,45,1593,186,682,186
14000US06037501700,6037501700,"Census Tract 5017, Los Angeles, CA",1196,47,809,102,387,94
14000US06037501802,6037501802,"Census Tract 5018.02, Los Angeles, CA",1175,61,599,100,576,98
14000US06037501803,6037501803,"Census Tract 5018.03, Los Angeles, CA",1490,55,183,70,1307,79
14000US06037501804,6037501804,"Census Tract 5018.04, Los Angeles, CA",705,37,175,49,530,55
14000US06037501900,6037501900,"Census Tract 5019, Los Angeles, CA",1276,60,1095,117,181,86
14000US06037502003,6037502003,"Census Tract 5020.03, Los Angeles, CA",739,46,403,63,336,68
14000US06037502004,6037502004,"Census Tract 5020.04, Los Angeles, CA",992,26,638,63,354,62
14000US06037502005,6037502005,"Census Tract 5020.05, Los Angeles, CA",1293,32,738,113,555,110
14000US06037502100,6037502100,"Census Tract 5021, Los Angeles, CA",1593,49,1032,143,561,145
14000US06037502200,6037502200,"Census Tract 5022, Los Angeles, CA",1875,49,1318,116,557,110
14000US06037502301,6037502301,"Census Tract 5023.01, Los Angeles, CA",1409,22,1054,122,355,113
14000US06037502302,6037502302,"Census Tract 5023.02, Los Angeles, CA",745,37,287,57,458,59
14000US06037502401,6037502401,"Census Tract 5024.01, Los Angeles, CA",1277,57,971,99,306,97
14000US06037502402,6037502402,"Census Tract 5024.02, Los Angeles, CA",990,35,845,55,145,59
14000US06037502500,6037502500,"Census Tract 5025, Los Angeles, CA",1117,48,517,71,600,84
14000US06037502601,6037502601,"Census Tract 5026.01, Los Angeles, CA",1846,57,1518,130,328,128
14000US06037502602,6037502602,"Census Tract 5026.02, Los Angeles, CA",1339,62,566,96,773,109
14000US06037502700,6037502700,"Census Tract 5027, Los Angeles, CA",1866,87,1450,103,416,98
14000US06037502801,6037502801,"Census Tract 5028.01, Los Angeles, CA",1692,91,1403,101,289,81
14000US06037502802,6037502802,"Census Tract 5028.02, Los Angeles, CA",1281,75,428,81,853,89
14000US06037502901,6037502901,"Census Tract 5029.01, Los Angeles, CA",1444,24,1255,88,189,80
14000US06037502902,6037502902,"Census Tract 5029.02, Los Angeles, CA",975,36,441,66,534,66
14000US06037503000,6037503000,"Census Tract 5030, Los Angeles, CA",1232,103,659,127,573,119
14000US06037503103,6037503103,"Census Tract 5031.03, Los Angeles, CA",1129,59,826,89,303,83
14000US06037503104,6037503104,"Census Tract 5031.04, Los Angeles, CA",625,28,381,51,244,51
14000US06037503105,6037503105,"Census Tract 5031.05, Los Angeles, CA",1056,34,550,88,506,89
14000US06037503106,6037503106,"Census Tract 5031.06, Los Angeles, CA",1180,17,684,106,496,111
14000US06037503201,6037503201,"Census Tract 5032.01, Los Angeles, CA",1095,60,1069,65,26,29
14000US06037503202,6037503202,"Census Tract 5032.02, Los Angeles, CA",1293,43,767,126,526,119
14000US06037503301,6037503301,"Census Tract 5033.01, Los Angeles, CA",1004,40,880,79,124,73
14000US06037503302,6037503302,"Census Tract 5033.02, Los Angeles, CA",1849,82,1025,111,824,124
14000US06037503401,6037503401,"Census Tract 5034.01, Los Angeles, CA",2209,129,1536,171,673,183
14000US06037503402,6037503402,"Census Tract 5034.02, Los Angeles, CA",1342,72,1022,81,320,77
14000US06037503501,6037503501,"Census Tract 5035.01, Los Angeles, CA",2006,66,1251,116,755,133
14000US06037503502,6037503502,"Census Tract 5035.02, Los Angeles, CA",1211,54,945,92,266,96
14000US06037503601,6037503601,"Census Tract 5036.01, Los Angeles, CA",1215,35,1058,66,157,60
14000US06037503602,6037503602,"Census Tract 5036.02, Los Angeles, CA",1182,45,1046,85,136,76
14000US06037503701,6037503701,"Census Tract 5037.01, Los Angeles, CA",1707,26,1032,105,675,111
14000US06037503702,6037503702,"Census Tract 5037.02, Los Angeles, CA",1753,59,1206,116,547,117
14000US06037503703,6037503703,"Census Tract 5037.03, Los Angeles, CA",2920,108,1985,184,935,179
14000US06037503801,6037503801,"Census Tract 5038.01, Los Angeles, CA",1167,50,859,90,308,77
14000US06037503802,6037503802,"Census Tract 5038.02, Los Angeles, CA",1622,48,1369,89,253,82
14000US06037503901,6037503901,"Census Tract 5039.01, Los Angeles, CA",827,32,707,69,120,57
14000US06037503902,6037503902,"Census Tract 5039.02, Los Angeles, CA",1378,39,1134,97,244,92
14000US06037504001,6037504001,"Census Tract 5040.01, Los Angeles, CA",1087,71,803,87,284,73
14000US06037504002,6037504002,"Census Tract 5040.02, Los Angeles, CA",1482,71,1191,106,291,103
14000US06037504101,6037504101,"Census Tract 5041.01, Los Angeles, CA",1337,61,837,88,500,94
14000US06037504102,6037504102,"Census Tract 5041.02, Los Angeles, CA",9,13,0,12,9,13
14000US06037530003,6037530003,"Census Tract 5300.03, Los Angeles, CA",961,31,889,51,72,43
14000US06037530004,6037530004,"Census Tract 5300.04, Los Angeles, CA",1113,80,563,91,550,102
14000US06037530005,6037530005,"Census Tract 5300.05, Los Angeles, CA",1342,83,1085,103,257,83
14000US06037530006,6037530006,"Census Tract 5300.06, Los Angeles, CA",1442,69,241,52,1201,88
14000US06037530101,6037530101,"Census Tract 5301.01, Los Angeles, CA",1684,90,360,101,1324,128
14000US06037530102,6037530102,"Census Tract 5301.02, Los Angeles, CA",1632,79,661,128,971,126
14000US06037530202,6037530202,"Census Tract 5302.02, Los Angeles, CA",1206,72,817,106,389,103
14000US06037530203,6037530203,"Census Tract 5302.03, Los Angeles, CA",985,82,291,76,694,86
14000US06037530204,6037530204,"Census Tract 5302.04, Los Angeles, CA",1145,51,327,85,818,93
14000US06037530301,6037530301,"Census Tract 5303.01, Los Angeles, CA",639,24,225,45,414,49
14000US06037530302,6037530302,"Census Tract 5303.02, Los Angeles, CA",1897,50,873,143,1024,141
14000US06037530400,6037530400,"Census Tract 5304, Los Angeles, CA",1203,96,410,81,793,108
14000US06037530500,6037530500,"Census Tract 5305, Los Angeles, CA",1118,87,401,101,717,112
14000US06037530601,6037530601,"Census Tract 5306.01, Los Angeles, CA",851,48,429,64,422,60
14000US06037530602,6037530602,"Census Tract 5306.02, Los Angeles, CA",413,10,236,60,177,59
14000US06037530700,6037530700,"Census Tract 5307, Los Angeles, CA",547,35,236,49,311,56
14000US06037530801,6037530801,"Census Tract 5308.01, Los Angeles, CA",1466,81,561,122,905,133
14000US06037530802,6037530802,"Census Tract 5308.02, Los Angeles, CA",914,47,538,73,376,83
14000US06037530901,6037530901,"Census Tract 5309.01, Los Angeles, CA",903,41,241,59,662,58
14000US06037530902,6037530902,"Census Tract 5309.02, Los Angeles, CA",1060,82,404,92,656,125
14000US06037531000,6037531000,"Census Tract 5310, Los Angeles, CA",1284,89,528,121,756,120
14000US06037531101,6037531101,"Census Tract 5311.01, Los Angeles, CA",1241,64,390,106,851,119
14000US06037531102,6037531102,"Census Tract 5311.02, Los Angeles, CA",897,39,205,50,692,65
14000US06037531201,6037531201,"Census Tract 5312.01, Los Angeles, CA",1272,48,362,115,910,116
14000US06037531202,6037531202,"Census Tract 5312.02, Los Angeles, CA",1145,82,346,86,799,108
14000US06037531301,6037531301,"Census Tract 5313.01, Los Angeles, CA",1232,75,261,78,971,109
14000US06037531302,6037531302,"Census Tract 5313.02, Los Angeles, CA",1490,64,484,121,1006,137
14000US06037531502,6037531502,"Census Tract 5315.02, Los Angeles, CA",807,43,173,49,634,64
14000US06037531503,6037531503,"Census Tract 5315.03, Los Angeles, CA",737,46,110,39,627,59
14000US06037531504,6037531504,"Census Tract 5315.04, Los Angeles, CA",1052,68,380,133,672,141
14000US06037531602,6037531602,"Census Tract 5316.02, Los Angeles, CA",1195,54,263,81,932,97
14000US06037531603,6037531603,"Census Tract 5316.03, Los Angeles, CA",875,42,314,60,561,67
14000US06037531604,6037531604,"Census Tract 5316.04, Los Angeles, CA",926,33,258,56,668,62
14000US06037531701,6037531701,"Census Tract 5317.01, Los Angeles, CA",1357,87,362,101,995,124
14000US06037531702,6037531702,"Census Tract 5317.02, Los Angeles, CA",1345,59,369,112,976,133
14000US06037531800,6037531800,"Census Tract 5318, Los Angeles, CA",1278,82,481,128,797,133
14000US06037531901,6037531901,"Census Tract 5319.01, Los Angeles, CA",1662,83,530,92,1132,119
14000US06037531902,6037531902,"Census Tract 5319.02, Los Angeles, CA",1156,40,606,90,550,94
14000US06037532001,6037532001,"Census Tract 5320.01, Los Angeles, CA",1009,86,249,69,760,80
14000US06037532002,6037532002,"Census Tract 5320.02, Los Angeles, CA",936,40,386,70,550,67
14000US06037532101,6037532101,"Census Tract 5321.01, Los Angeles, CA",1774,70,488,98,1286,111
14000US06037532102,6037532102,"Census Tract 5321.02, Los Angeles, CA",1013,73,662,93,351,92
14000US06037532200,6037532200,"Census Tract 5322, Los Angeles, CA",1754,83,584,96,1170,116
14000US06037532302,6037532302,"Census Tract 5323.02, Los Angeles, CA",1130,60,567,93,563,97
14000US06037532303,6037532303,"Census Tract 5323.03, Los Angeles, CA",1339,63,708,104,631,92
14000US06037532304,6037532304,"Census Tract 5323.04, Los Angeles, CA",1090,76,385,67,705,103
14000US06037532400,6037532400,"Census Tract 5324, Los Angeles, CA",21,11,4,5,17,10
14000US06037532500,6037532500,"Census Tract 5325, Los Angeles, CA",1120,38,392,79,728,84
14000US06037532603,6037532603,"Census Tract 5326.03, Los Angeles, CA",759,29,211,54,548,63
14000US06037532604,6037532604,"Census Tract 5326.04, Los Angeles, CA",687,36,131,38,556,49
14000US06037532605,6037532605,"Census Tract 5326.05, Los Angeles, CA",1072,62,198,65,874,79
14000US06037532606,6037532606,"Census Tract 5326.06, Los Angeles, CA",1278,43,152,65,1126,73
14000US06037532700,6037532700,"Census Tract 5327, Los Angeles, CA",691,52,147,54,544,73
14000US06037532800,6037532800,"Census Tract 5328, Los Angeles, CA",1008,53,373,77,635,79
14000US06037532900,6037532900,"Census Tract 5329, Los Angeles, CA",1653,59,428,100,1225,108
14000US06037533001,6037533001,"Census Tract 5330.01, Los Angeles, CA",1044,71,306,86,738,101
14000US06037533002,6037533002,"Census Tract 5330.02, Los Angeles, CA",597,44,239,50,358,61
14000US06037533103,6037533103,"Census Tract 5331.03, Los Angeles, CA",815,36,95,39,720,55
14000US06037533104,6037533104,"Census Tract 5331.04, Los Angeles, CA",1266,52,129,58,1137,78
14000US06037533105,6037533105,"Census Tract 5331.05, Los Angeles, CA",647,32,91,53,556,61
14000US06037533106,6037533106,"Census Tract 5331.06, Los Angeles, CA",399,31,115,38,284,41
14000US06037533107,6037533107,"Census Tract 5331.07, Los Angeles, CA",935,55,128,38,807,60
14000US06037533201,6037533201,"Census Tract 5332.01, Los Angeles, CA",676,31,187,55,489,56
14000US06037533202,6037533202,"Census Tract 5332.02, Los Angeles, CA",648,27,237,64,411,65
14000US06037533203,6037533203,"Census Tract 5332.03, Los Angeles, CA",415,27,121,45,294,44
14000US06037533300,6037533300,"Census Tract 5333, Los Angeles, CA",868,45,150,52,718,71
14000US06037533401,6037533401,"Census Tract 5334.01, Los Angeles, CA",1218,50,475,100,743,97
14000US06037533402,6037533402,"Census Tract 5334.02, Los Angeles, CA",1062,46,248,71,814,83
14000US06037533403,6037533403,"Census Tract 5334.03, Los Angeles, CA",742,38,210,46,532,47
14000US06037533501,6037533501,"Census Tract 5335.01, Los Angeles, CA",723,40,228,62,495,62
14000US06037533502,6037533502,"Census Tract 5335.02, Los Angeles, CA",483,26,230,35,253,44
14000US06037533503,6037533503,"Census Tract 5335.03, Los Angeles, CA",468,24,165,38,303,43
14000US06037533601,6037533601,"Census Tract 5336.01, Los Angeles, CA",1119,56,187,83,932,94
14000US06037533602,6037533602,"Census Tract 5336.02, Los Angeles, CA",1406,60,365,91,1041,108
14000US06037533603,6037533603,"Census Tract 5336.03, Los Angeles, CA",1783,80,495,109,1288,121
14000US06037533701,6037533701,"Census Tract 5337.01, Los Angeles, CA",900,61,200,52,700,77
14000US06037533702,6037533702,"Census Tract 5337.02, Los Angeles, CA",868,39,188,43,680,55
14000US06037533703,6037533703,"Census Tract 5337.03, Los Angeles, CA",1037,57,276,89,761,105
14000US06037533803,6037533803,"Census Tract 5338.03, Los Angeles, CA",1600,84,492,93,1108,116
14000US06037533804,6037533804,"Census Tract 5338.04, Los Angeles, CA",1193,65,482,110,711,120
14000US06037533805,6037533805,"Census Tract 5338.05, Los Angeles, CA",924,53,353,75,571,81
14000US06037533806,6037533806,"Census Tract 5338.06, Los Angeles, CA",947,80,294,76,653,95
14000US06037533901,6037533901,"Census Tract 5339.01, Los Angeles, CA",1453,49,311,75,1142,92
14000US06037533902,6037533902,"Census Tract 5339.02, Los Angeles, CA",958,37,212,49,746,55
14000US06037534001,6037534001,"Census Tract 5340.01, Los Angeles, CA",1267,61,225,78,1042,100
14000US06037534002,6037534002,"Census Tract 5340.02, Los Angeles, CA",1008,41,347,67,661,76
14000US06037534101,6037534101,"Census Tract 5341.01, Los Angeles, CA",505,36,137,37,368,49
14000US06037534102,6037534102,"Census Tract 5341.02, Los Angeles, CA",1463,60,154,58,1309,69
14000US06037534201,6037534201,"Census Tract 5342.01, Los Angeles, CA",1027,33,283,61,744,68
14000US06037534202,6037534202,"Census Tract 5342.02, Los Angeles, CA",1279,59,243,99,1036,105
14000US06037534203,6037534203,"Census Tract 5342.03, Los Angeles, CA",863,41,185,60,678,74
14000US06037534301,6037534301,"Census Tract 5343.01, Los Angeles, CA",1136,56,154,55,982,79
14000US06037534302,6037534302,"Census Tract 5343.02, Los Angeles, CA",834,34,157,44,677,49
14000US06037534403,6037534403,"Census Tract 5344.03, Los Angeles, CA",714,39,92,42,622,54
14000US06037534404,6037534404,"Census Tract 5344.04, Los Angeles, CA",976,37,198,61,778,63
14000US06037534405,6037534405,"Census Tract 5344.05, Los Angeles, CA",962,56,102,47,860,76
14000US06037534406,6037534406,"Census Tract 5344.06, Los Angeles, CA",1068,54,68,45,1000,67
14000US06037534501,6037534501,"Census Tract 5345.01, Los Angeles, CA",1239,61,510,107,729,117
14000US06037534502,6037534502,"Census Tract 5345.02, Los Angeles, CA",988,55,661,94,327,90
14000US06037534700,6037534700,"Census Tract 5347, Los Angeles, CA",1008,16,742,65,266,67
14000US06037534802,6037534802,"Census Tract 5348.02, Los Angeles, CA",705,27,403,61,302,65
14000US06037534803,6037534803,"Census Tract 5348.03, Los Angeles, CA",1177,47,510,100,667,106
14000US06037534804,6037534804,"Census Tract 5348.04, Los Angeles, CA",885,51,431,72,454,77
14000US06037534900,6037534900,"Census Tract 5349, Los Angeles, CA",1476,66,655,135,821,127
14000US06037535001,6037535001,"Census Tract 5350.01, Los Angeles, CA",1019,57,378,79,641,91
14000US06037535002,6037535002,"Census Tract 5350.02, Los Angeles, CA",842,18,317,63,525,62
14000US06037535101,6037535101,"Census Tract 5351.01, Los Angeles, CA",1795,63,593,116,1202,119
14000US06037535102,6037535102,"Census Tract 5351.02, Los Angeles, CA",1043,62,510,96,533,103
14000US06037535200,6037535200,"Census Tract 5352, Los Angeles, CA",1263,74,562,87,701,116
14000US06037535300,6037535300,"Census Tract 5353, Los Angeles, CA",1428,75,705,104,723,110
14000US06037535400,6037535400,"Census Tract 5354, Los Angeles, CA",771,32,205,63,566,67
14000US06037535501,6037535501,"Census Tract 5355.01, Los Angeles, CA",1017,31,191,54,826,62
14000US06037535502,6037535502,"Census Tract 5355.02, Los Angeles, CA",1246,43,398,102,848,108
14000US06037535503,6037535503,"Census Tract 5355.03, Los Angeles, CA",643,31,231,55,412,49
14000US06037535603,6037535603,"Census Tract 5356.03, Los Angeles, CA",1019,37,373,63,646,69
14000US06037535604,6037535604,"Census Tract 5356.04, Los Angeles, CA",1020,39,367,57,653,64
14000US06037535605,6037535605,"Census Tract 5356.05, Los Angeles, CA",1122,30,259,74,863,76
14000US06037535606,6037535606,"Census Tract 5356.06, Los Angeles, CA",451,38,145,43,306,54
14000US06037535607,6037535607,"Census Tract 5356.07, Los Angeles, CA",1090,44,648,98,442,100
14000US06037535701,6037535701,"Census Tract 5357.01, Los Angeles, CA",1420,86,540,97,880,103
14000US06037535702,6037535702,"Census Tract 5357.02, Los Angeles, CA",1439,50,477,110,962,108
14000US06037535802,6037535802,"Census Tract 5358.02, Los Angeles, CA",1609,70,862,110,747,115
14000US06037535803,6037535803,"Census Tract 5358.03, Los Angeles, CA",1121,31,303,86,818,90
14000US06037535804,6037535804,"Census Tract 5358.04, Los Angeles, CA",1346,67,470,93,876,110
14000US06037535901,6037535901,"Census Tract 5359.01, Los Angeles, CA",1448,52,717,115,731,118
14000US06037535902,6037535902,"Census Tract 5359.02, Los Angeles, CA",1578,57,1091,127,487,129
14000US06037536000,6037536000,"Census Tract 5360, Los Angeles, CA",1008,34,229,60,779,64
14000US06037536102,6037536102,"Census Tract 5361.02, Los Angeles, CA",1036,61,731,121,305,100
14000US06037536103,6037536103,"Census Tract 5361.03, Los Angeles, CA",1481,46,775,114,706,111
14000US06037536104,6037536104,"Census Tract 5361.04, Los Angeles, CA",1032,40,425,74,607,76
14000US06037536200,6037536200,"Census Tract 5362, Los Angeles, CA",1945,79,1083,128,862,147
14000US06037540000,6037540000,"Census Tract 5400, Los Angeles, CA",1587,45,553,122,1034,131
14000US06037540101,6037540101,"Census Tract 5401.01, Los Angeles, CA",1475,49,1077,110,398,101
14000US06037540102,6037540102,"Census Tract 5401.02, Los Angeles, CA",1562,57,988,127,574,115
14000US06037540201,6037540201,"Census Tract 5402.01, Los Angeles, CA",591,20,103,30,488,34
14000US06037540202,6037540202,"Census Tract 5402.02, Los Angeles, CA",1601,61,333,78,1268,93
14000US06037540203,6037540203,"Census Tract 5402.03, Los Angeles, CA",1282,62,414,82,868,101
14000US06037540300,6037540300,"Census Tract 5403, Los Angeles, CA",1172,49,649,93,523,92
14000US06037540400,6037540400,"Census Tract 5404, Los Angeles, CA",442,27,227,59,215,61
14000US06037540501,6037540501,"Census Tract 5405.01, Los Angeles, CA",1053,51,606,78,447,94
14000US06037540502,6037540502,"Census Tract 5405.02, Los Angeles, CA",1454,75,204,69,1250,94
14000US06037540600,6037540600,"Census Tract 5406, Los Angeles, CA",1130,72,356,100,774,117
14000US06037540700,6037540700,"Census Tract 5407, Los Angeles, CA",810,52,409,84,401,90
14000US06037540800,6037540800,"Census Tract 5408, Los Angeles, CA",1514,162,1031,149,483,133
14000US06037540901,6037540901,"Census Tract 5409.01, Los Angeles, CA",1201,76,717,135,484,150
14000US06037540902,6037540902,"Census Tract 5409.02, Los Angeles, CA",1487,61,922,128,565,127
14000US06037541001,6037541001,"Census Tract 5410.01, Los Angeles, CA",365,24,305,38,60,33
14000US06037541002,6037541002,"Census Tract 5410.02, Los Angeles, CA",982,54,830,78,152,71
14000US06037541100,6037541100,"Census Tract 5411, Los Angeles, CA",918,40,630,76,288,70
14000US06037541200,6037541200,"Census Tract 5412, Los Angeles, CA",1853,99,1340,159,513,153
14000US06037541300,6037541300,"Census Tract 5413, Los Angeles, CA",1473,62,1034,117,439,116
14000US06037541400,6037541400,"Census Tract 5414, Los Angeles, CA",1696,84,775,155,921,154
14000US06037541500,6037541500,"Census Tract 5415, Los Angeles, CA",1349,57,436,108,913,118
14000US06037541603,6037541603,"Census Tract 5416.03, Los Angeles, CA",676,30,262,49,414,53
14000US06037541604,6037541604,"Census Tract 5416.04, Los Angeles, CA",1453,72,441,101,1012,112
14000US06037541605,6037541605,"Census Tract 5416.05, Los Angeles, CA",1289,68,503,103,786,101
14000US06037541606,6037541606,"Census Tract 5416.06, Los Angeles, CA",611,23,181,42,430,45
14000US06037541700,6037541700,"Census Tract 5417, Los Angeles, CA",1396,42,1000,105,396,102
14000US06037541801,6037541801,"Census Tract 5418.01, Los Angeles, CA",1322,45,572,114,750,122
14000US06037541802,6037541802,"Census Tract 5418.02, Los Angeles, CA",1150,36,767,82,383,80
14000US06037542000,6037542000,"Census Tract 5420, Los Angeles, CA",1141,84,722,115,419,110
14000US06037542103,6037542103,"Census Tract 5421.03, Los Angeles, CA",847,41,448,63,399,69
14000US06037542104,6037542104,"Census Tract 5421.04, Los Angeles, CA",706,40,429,52,277,52
14000US06037542105,6037542105,"Census Tract 5421.05, Los Angeles, CA",1095,50,395,89,700,101
14000US06037542106,6037542106,"Census Tract 5421.06, Los Angeles, CA",777,46,305,72,472,71
14000US06037542200,6037542200,"Census Tract 5422, Los Angeles, CA",1576,68,998,141,578,141
14000US06037542401,6037542401,"Census Tract 5424.01, Los Angeles, CA",1223,67,789,111,434,91
14000US06037542402,6037542402,"Census Tract 5424.02, Los Angeles, CA",758,44,538,75,220,69
14000US06037542501,6037542501,"Census Tract 5425.01, Los Angeles, CA",1167,66,623,121,544,117
14000US06037542502,6037542502,"Census Tract 5425.02, Los Angeles, CA",1303,64,380,88,923,103
14000US06037542601,6037542601,"Census Tract 5426.01, Los Angeles, CA",677,37,177,50,500,63
14000US06037542602,6037542602,"Census Tract 5426.02, Los Angeles, CA",1421,87,580,107,841,112
14000US06037542700,6037542700,"Census Tract 5427, Los Angeles, CA",1345,59,837,111,508,111
14000US06037542800,6037542800,"Census Tract 5428, Los Angeles, CA",899,47,739,72,160,63
14000US06037542900,6037542900,"Census Tract 5429, Los Angeles, CA",737,35,437,57,300,58
14000US06037543000,6037543000,"Census Tract 5430, Los Angeles, CA",1168,75,774,116,394,114
14000US06037543100,6037543100,"Census Tract 5431, Los Angeles, CA",1765,84,1257,158,508,153
14000US06037543201,6037543201,"Census Tract 5432.01, Los Angeles, CA",908,67,549,88,359,75
14000US06037543202,6037543202,"Census Tract 5432.02, Los Angeles, CA",1160,60,548,88,612,85
14000US06037543304,6037543304,"Census Tract 5433.04, Los Angeles, CA",1946,86,1746,143,200,115
14000US06037543305,6037543305,"Census Tract 5433.05, Los Angeles, CA",1077,19,957,101,120,96
14000US06037543306,6037543306,"Census Tract 5433.06, Los Angeles, CA",2123,58,1391,185,732,186
14000US06037543321,6037543321,"Census Tract 5433.21, Los Angeles, CA",1831,57,1494,129,337,125
14000US06037543322,6037543322,"Census Tract 5433.22, Los Angeles, CA",2154,60,2020,122,134,103
14000US06037543400,6037543400,"Census Tract 5434, Los Angeles, CA",954,47,732,69,222,69
14000US06037543501,6037543501,"Census Tract 5435.01, Los Angeles, CA",2051,74,1021,173,1030,175
14000US06037543502,6037543502,"Census Tract 5435.02, Los Angeles, CA",1351,94,825,131,526,140
14000US06037543503,6037543503,"Census Tract 5435.03, Los Angeles, CA",1772,82,1065,111,707,131
14000US06037543601,6037543601,"Census Tract 5436.01, Los Angeles, CA",966,74,648,93,318,92
14000US06037543602,6037543602,"Census Tract 5436.02, Los Angeles, CA",2852,133,2195,214,657,217
14000US06037543603,6037543603,"Census Tract 5436.03, Los Angeles, CA",1508,39,1301,99,207,92
14000US06037543604,6037543604,"Census Tract 5436.04, Los Angeles, CA",1370,50,1160,90,210,81
14000US06037543701,6037543701,"Census Tract 5437.01, Los Angeles, CA",622,35,460,61,162,58
14000US06037543702,6037543702,"Census Tract 5437.02, Los Angeles, CA",1797,77,1282,128,515,117
14000US06037543703,6037543703,"Census Tract 5437.03, Los Angeles, CA",907,57,690,73,217,65
14000US06037543801,6037543801,"Census Tract 5438.01, Los Angeles, CA",1360,89,1111,98,249,92
14000US06037543802,6037543802,"Census Tract 5438.02, Los Angeles, CA",1941,140,1032,158,909,168
14000US06037543903,6037543903,"Census Tract 5439.03, Los Angeles, CA",1144,47,814,83,330,89
14000US06037543905,6037543905,"Census Tract 5439.05, Los Angeles, CA",949,35,550,68,399,75
14000US06037544001,6037544001,"Census Tract 5440.01, Los Angeles, CA",1144,66,754,110,390,117
14000US06037544002,6037544002,"Census Tract 5440.02, Los Angeles, CA",808,31,569,63,239,56
14000US06037550000,6037550000,"Census Tract 5500, Los Angeles, CA",149,30,126,26,23,22
14000US06037550100,6037550100,"Census Tract 5501, Los Angeles, CA",1850,60,1468,134,382,124
14000US06037550201,6037550201,"Census Tract 5502.01, Los Angeles, CA",769,33,459,58,310,53
14000US06037550202,6037550202,"Census Tract 5502.02, Los Angeles, CA",1453,52,1149,114,304,107
14000US06037550300,6037550300,"Census Tract 5503, Los Angeles, CA",2047,115,1302,175,745,159
14000US06037550400,6037550400,"Census Tract 5504, Los Angeles, CA",371,33,351,37,20,16
14000US06037550500,6037550500,"Census Tract 5505, Los Angeles, CA",2337,80,1505,188,832,187
14000US06037550601,6037550601,"Census Tract 5506.01, Los Angeles, CA",1721,73,793,97,928,95
14000US06037550602,6037550602,"Census Tract 5506.02, Los Angeles, CA",1216,45,1048,73,168,57
14000US06037550700,6037550700,"Census Tract 5507, Los Angeles, CA",1797,137,1382,174,415,142
14000US06037550800,6037550800,"Census Tract 5508, Los Angeles, CA",2077,129,1174,184,903,167
14000US06037550901,6037550901,"Census Tract 5509.01, Los Angeles, CA",1357,77,267,66,1090,98
14000US06037550902,6037550902,"Census Tract 5509.02, Los Angeles, CA",1884,62,463,89,1421,111
14000US06037551000,6037551000,"Census Tract 5510, Los Angeles, CA",2182,90,1430,158,752,157
14000US06037551101,6037551101,"Census Tract 5511.01, Los Angeles, CA",1181,57,388,97,793,105
14000US06037551102,6037551102,"Census Tract 5511.02, Los Angeles, CA",1666,68,184,68,1482,94
14000US06037551201,6037551201,"Census Tract 5512.01, Los Angeles, CA",1129,41,412,82,717,82
14000US06037551202,6037551202,"Census Tract 5512.02, Los Angeles, CA",2144,104,899,131,1245,156
14000US06037551300,6037551300,"Census Tract 5513, Los Angeles, CA",1704,98,434,111,1270,122
14000US06037551401,6037551401,"Census Tract 5514.01, Los Angeles, CA",1356,65,539,92,817,110
14000US06037551402,6037551402,"Census Tract 5514.02, Los Angeles, CA",1280,48,833,122,447,124
14000US06037551501,6037551501,"Census Tract 5515.01, Los Angeles, CA",1425,74,873,109,552,106
14000US06037551502,6037551502,"Census Tract 5515.02, Los Angeles, CA",1225,44,680,105,545,110
14000US06037551600,6037551600,"Census Tract 5516, Los Angeles, CA",0,12,0,12,0,12
14000US06037551700,6037551700,"Census Tract 5517, Los Angeles, CA",1680,64,979,143,701,129
14000US06037551800,6037551800,"Census Tract 5518, Los Angeles, CA",2375,95,1262,158,1113,178
14000US06037551900,6037551900,"Census Tract 5519, Los Angeles, CA",1416,72,1032,132,384,111
14000US06037552001,6037552001,"Census Tract 5520.01, Los Angeles, CA",982,40,680,79,302,68
14000US06037552002,6037552002,"Census Tract 5520.02, Los Angeles, CA",918,55,439,69,479,70
14000US06037552100,6037552100,"Census Tract 5521, Los Angeles, CA",1856,62,1150,113,706,105
14000US06037552200,6037552200,"Census Tract 5522, Los Angeles, CA",1646,102,367,96,1279,126
14000US06037552301,6037552301,"Census Tract 5523.01, Los Angeles, CA",1224,74,756,110,468,108
14000US06037552302,6037552302,"Census Tract 5523.02, Los Angeles, CA",1243,40,632,113,611,110
14000US06037552400,6037552400,"Census Tract 5524, Los Angeles, CA",569,39,436,48,133,44
14000US06037552601,6037552601,"Census Tract 5526.01, Los Angeles, CA",1178,45,844,102,334,95
14000US06037552602,6037552602,"Census Tract 5526.02, Los Angeles, CA",1101,57,712,77,389,83
14000US06037552700,6037552700,"Census Tract 5527, Los Angeles, CA",1702,65,1289,115,413,108
14000US06037552800,6037552800,"Census Tract 5528, Los Angeles, CA",1627,70,1013,131,614,131
14000US06037552900,6037552900,"Census Tract 5529, Los Angeles, CA",1925,91,1062,143,863,134
14000US06037553000,6037553000,"Census Tract 5530, Los Angeles, CA",1249,32,994,106,255,101
14000US06037553100,6037553100,"Census Tract 5531, Los Angeles, CA",1896,89,879,116,1017,117
14000US06037553200,6037553200,"Census Tract 5532, Los Angeles, CA",1954,73,1394,123,560,121
14000US06037553300,6037553300,"Census Tract 5533, Los Angeles, CA",989,65,748,108,241,100
14000US06037553400,6037553400,"Census Tract 5534, Los Angeles, CA",938,40,585,74,353,75
14000US06037553502,6037553502,"Census Tract 5535.02, Los Angeles, CA",1195,94,502,108,693,124
14000US06037553503,6037553503,"Census Tract 5535.03, Los Angeles, CA",751,50,251,58,500,69
14000US06037553504,6037553504,"Census Tract 5535.04, Los Angeles, CA",1362,49,716,99,646,107
14000US06037553601,6037553601,"Census Tract 5536.01, Los Angeles, CA",1274,57,403,92,871,110
14000US06037553602,6037553602,"Census Tract 5536.02, Los Angeles, CA",1375,57,456,87,919,96
14000US06037553701,6037553701,"Census Tract 5537.01, Los Angeles, CA",899,34,368,69,531,72
14000US06037553702,6037553702,"Census Tract 5537.02, Los Angeles, CA",1090,56,609,105,481,106
14000US06037553801,6037553801,"Census Tract 5538.01, Los Angeles, CA",1080,50,244,64,836,81
14000US06037553802,6037553802,"Census Tract 5538.02, Los Angeles, CA",2023,60,826,131,1197,135
14000US06037553901,6037553901,"Census Tract 5539.01, Los Angeles, CA",1619,77,860,108,759,119
14000US06037553902,6037553902,"Census Tract 5539.02, Los Angeles, CA",1539,86,588,114,951,134
14000US06037554001,6037554001,"Census Tract 5540.01, Los Angeles, CA",1060,82,706,108,354,117
14000US06037554002,6037554002,"Census Tract 5540.02, Los Angeles, CA",1681,100,553,94,1128,119
14000US06037554101,6037554101,"Census Tract 5541.01, Los Angeles, CA",997,76,349,61,648,94
14000US06037554103,6037554103,"Census Tract 5541.03, Los Angeles, CA",431,31,279,43,152,40
14000US06037554104,6037554104,"Census Tract 5541.04, Los Angeles, CA",737,51,183,52,554,65
14000US06037554105,6037554105,"Census Tract 5541.05, Los Angeles, CA",1444,100,85,44,1359,102
14000US06037554201,6037554201,"Census Tract 5542.01, Los Angeles, CA",1172,44,670,127,502,115
14000US06037554203,6037554203,"Census Tract 5542.03, Los Angeles, CA",1222,49,427,77,795,84
14000US06037554204,6037554204,"Census Tract 5542.04, Los Angeles, CA",1671,99,267,91,1404,119
14000US06037554301,6037554301,"Census Tract 5543.01, Los Angeles, CA",1020,50,433,105,587,104
14000US06037554302,6037554302,"Census Tract 5543.02, Los Angeles, CA",1223,60,396,118,827,119
14000US06037554403,6037554403,"Census Tract 5544.03, Los Angeles, CA",1713,83,421,91,1292,104
14000US06037554404,6037554404,"Census Tract 5544.04, Los Angeles, CA",1297,107,263,95,1034,142
14000US06037554405,6037554405,"Census Tract 5544.05, Los Angeles, CA",1113,101,233,101,880,113
14000US06037554406,6037554406,"Census Tract 5544.06, Los Angeles, CA",1620,77,840,104,780,126
14000US06037554511,6037554511,"Census Tract 5545.11, Los Angeles, CA",1191,55,942,84,249,77
14000US06037554512,6037554512,"Census Tract 5545.12, Los Angeles, CA",1983,108,1589,130,394,104
14000US06037554513,6037554513,"Census Tract 5545.13, Los Angeles, CA",821,28,586,64,235,61
14000US06037554514,6037554514,"Census Tract 5545.14, Los Angeles, CA",1444,59,962,124,482,106
14000US06037554515,6037554515,"Census Tract 5545.15, Los Angeles, CA",1104,67,852,105,252,100
14000US06037554516,6037554516,"Census Tract 5545.16, Los Angeles, CA",1161,59,1062,69,99,57
14000US06037554517,6037554517,"Census Tract 5545.17, Los Angeles, CA",1447,98,936,109,511,105
14000US06037554518,6037554518,"Census Tract 5545.18, Los Angeles, CA",1623,65,1394,113,229,88
14000US06037554519,6037554519,"Census Tract 5545.19, Los Angeles, CA",1205,60,1063,86,142,71
14000US06037554521,6037554521,"Census Tract 5545.21, Los Angeles, CA",1903,85,1225,91,678,108
14000US06037554522,6037554522,"Census Tract 5545.22, Los Angeles, CA",1496,58,1285,80,211,73
14000US06037554600,6037554600,"Census Tract 5546, Los Angeles, CA",1251,62,644,102,607,105
14000US06037554700,6037554700,"Census Tract 5547, Los Angeles, CA",976,60,681,81,295,83
14000US06037554801,6037554801,"Census Tract 5548.01, Los Angeles, CA",727,61,404,84,323,73
14000US06037554802,6037554802,"Census Tract 5548.02, Los Angeles, CA",1628,123,786,118,842,144
14000US06037554900,6037554900,"Census Tract 5549, Los Angeles, CA",2105,133,965,150,1140,160
14000US06037555001,6037555001,"Census Tract 5550.01, Los Angeles, CA",1472,70,929,112,543,96
14000US06037555002,6037555002,"Census Tract 5550.02, Los Angeles, CA",1117,53,585,96,532,88
14000US06037555102,6037555102,"Census Tract 5551.02, Los Angeles, CA",1879,110,812,138,1067,151
14000US06037555103,6037555103,"Census Tract 5551.03, Los Angeles, CA",1458,59,802,94,656,99
14000US06037555104,6037555104,"Census Tract 5551.04, Los Angeles, CA",1291,89,720,117,571,107
14000US06037555202,6037555202,"Census Tract 5552.02, Los Angeles, CA",1083,54,962,76,121,74
14000US06037555211,6037555211,"Census Tract 5552.11, Los Angeles, CA",1373,100,615,109,758,115
14000US06037555212,6037555212,"Census Tract 5552.12, Los Angeles, CA",1204,95,608,134,596,127
14000US06037570001,6037570001,"Census Tract 5700.01, Los Angeles, CA",1464,51,1068,72,396,74
14000US06037570002,6037570002,"Census Tract 5700.02, Los Angeles, CA",837,43,660,54,177,55
14000US06037570003,6037570003,"Census Tract 5700.03, Los Angeles, CA",1334,64,1016,100,318,94
14000US06037570100,6037570100,"Census Tract 5701, Los Angeles, CA",754,36,539,86,215,78
14000US06037570202,6037570202,"Census Tract 5702.02, Los Angeles, CA",1609,59,1096,128,513,119
14000US06037570203,6037570203,"Census Tract 5702.03, Los Angeles, CA",1205,50,182,62,1023,74
14000US06037570204,6037570204,"Census Tract 5702.04, Los Angeles, CA",1198,46,350,113,848,122
14000US06037570301,6037570301,"Census Tract 5703.01, Los Angeles, CA",2255,97,561,136,1694,153
14000US06037570303,6037570303,"Census Tract 5703.03, Los Angeles, CA",1248,76,617,132,631,117
14000US06037570304,6037570304,"Census Tract 5703.04, Los Angeles, CA",1439,64,537,93,902,98
14000US06037570402,6037570402,"Census Tract 5704.02, Los Angeles, CA",953,40,690,71,263,67
14000US06037570403,6037570403,"Census Tract 5704.03, Los Angeles, CA",1124,60,408,83,716,99
14000US06037570404,6037570404,"Census Tract 5704.04, Los Angeles, CA",857,32,516,57,341,54
14000US06037570501,6037570501,"Census Tract 5705.01, Los Angeles, CA",2086,108,1176,220,910,218
14000US06037570502,6037570502,"Census Tract 5705.02, Los Angeles, CA",1824,60,945,141,879,142
14000US06037570601,6037570601,"Census Tract 5706.01, Los Angeles, CA",1541,75,678,122,863,135
14000US06037570602,6037570602,"Census Tract 5706.02, Los Angeles, CA",1834,73,743,106,1091,109
14000US06037570603,6037570603,"Census Tract 5706.03, Los Angeles, CA",1804,85,282,63,1522,105
14000US06037570701,6037570701,"Census Tract 5707.01, Los Angeles, CA",2596,72,1315,147,1281,144
14000US06037570702,6037570702,"Census Tract 5707.02, Los Angeles, CA",790,40,698,58,92,44
14000US06037570800,6037570800,"Census Tract 5708, Los Angeles, CA",1727,77,1415,119,312,101
14000US06037570901,6037570901,"Census Tract 5709.01, Los Angeles, CA",1789,69,1534,107,255,97
14000US06037570902,6037570902,"Census Tract 5709.02, Los Angeles, CA",1202,51,820,92,382,82
14000US06037571000,6037571000,"Census Tract 5710, Los Angeles, CA",1882,66,1680,112,202,86
14000US06037571101,6037571101,"Census Tract 5711.01, Los Angeles, CA",1470,65,1273,111,197,82
14000US06037571102,6037571102,"Census Tract 5711.02, Los Angeles, CA",1304,44,1042,120,262,112
14000US06037571200,6037571200,"Census Tract 5712, Los Angeles, CA",3089,67,1581,171,1508,179
14000US06037571300,6037571300,"Census Tract 5713, Los Angeles, CA",1456,52,1317,85,139,69
14000US06037571400,6037571400,"Census Tract 5714, Los Angeles, CA",1667,52,1153,115,514,110
14000US06037571502,6037571502,"Census Tract 5715.02, Los Angeles, CA",1775,84,988,137,787,153
14000US06037571503,6037571503,"Census Tract 5715.03, Los Angeles, CA",1268,58,779,113,489,112
14000US06037571504,6037571504,"Census Tract 5715.04, Los Angeles, CA",1879,89,764,119,1115,144
14000US06037571600,6037571600,"Census Tract 5716, Los Angeles, CA",823,37,33,23,790,44
14000US06037571701,6037571701,"Census Tract 5717.01, Los Angeles, CA",1813,85,653,124,1160,132
14000US06037571703,6037571703,"Census Tract 5717.03, Los Angeles, CA",1065,69,408,65,657,80
14000US06037571704,6037571704,"Census Tract 5717.04, Los Angeles, CA",1235,36,531,94,704,100
14000US06037571800,6037571800,"Census Tract 5718, Los Angeles, CA",1330,58,964,79,366,83
14000US06037571900,6037571900,"Census Tract 5719, Los Angeles, CA",2306,139,1049,155,1257,188
14000US06037572001,6037572001,"Census Tract 5720.01, Los Angeles, CA",2156,82,1371,155,785,167
14000US06037572002,6037572002,"Census Tract 5720.02, Los Angeles, CA",1984,108,700,118,1284,141
14000US06037572100,6037572100,"Census Tract 5721, Los Angeles, CA",319,18,311,19,8,8
14000US06037572201,6037572201,"Census Tract 5722.01, Los Angeles, CA",2078,98,1207,152,871,166
14000US06037572202,6037572202,"Census Tract 5722.02, Los Angeles, CA",1094,50,761,82,333,91
14000US06037572301,6037572301,"Census Tract 5723.01, Los Angeles, CA",963,51,374,69,589,88
14000US06037572302,6037572302,"Census Tract 5723.02, Los Angeles, CA",835,40,493,59,342,63
14000US06037572400,6037572400,"Census Tract 5724, Los Angeles, CA",323,73,297,69,26,28
14000US06037572500,6037572500,"Census Tract 5725, Los Angeles, CA",1232,92,423,90,809,102
14000US06037572600,6037572600,"Census Tract 5726, Los Angeles, CA",1217,76,905,115,312,104
14000US06037572700,6037572700,"Census Tract 5727, Los Angeles, CA",1334,62,851,103,483,107
14000US06037572800,6037572800,"Census Tract 5728, Los Angeles, CA",226,50,0,12,226,50
14000US06037572900,6037572900,"Census Tract 5729, Los Angeles, CA",1318,49,465,112,853,116
14000US06037573002,6037573002,"Census Tract 5730.02, Los Angeles, CA",1131,80,98,61,1033,91
14000US06037573003,6037573003,"Census Tract 5730.03, Los Angeles, CA",622,26,364,53,258,54
14000US06037573004,6037573004,"Census Tract 5730.04, Los Angeles, CA",1655,84,203,71,1452,107
14000US06037573100,6037573100,"Census Tract 5731, Los Angeles, CA",2406,125,760,189,1646,203
14000US06037573201,6037573201,"Census Tract 5732.01, Los Angeles, CA",1318,62,376,74,942,89
14000US06037573202,6037573202,"Census Tract 5732.02, Los Angeles, CA",1697,69,573,87,1124,110
14000US06037573300,6037573300,"Census Tract 5733, Los Angeles, CA",1094,40,271,69,823,73
14000US06037573401,6037573401,"Census Tract 5734.01, Los Angeles, CA",645,50,232,57,413,61
14000US06037573402,6037573402,"Census Tract 5734.02, Los Angeles, CA",2614,160,1112,216,1502,241
14000US06037573403,6037573403,"Census Tract 5734.03, Los Angeles, CA",1484,111,1135,137,349,109
14000US06037573601,6037573601,"Census Tract 5736.01, Los Angeles, CA",2201,81,1855,126,346,132
14000US06037573700,6037573700,"Census Tract 5737, Los Angeles, CA",1712,47,1495,97,217,95
14000US06037573800,6037573800,"Census Tract 5738, Los Angeles, CA",1489,62,1296,97,193,88
14000US06037573902,6037573902,"Census Tract 5739.02, Los Angeles, CA",856,39,735,54,121,47
14000US06037574000,6037574000,"Census Tract 5740, Los Angeles, CA",1853,77,1660,108,193,78
14000US06037574100,6037574100,"Census Tract 5741, Los Angeles, CA",1906,41,1531,104,375,108
14000US06037574201,6037574201,"Census Tract 5742.01, Los Angeles, CA",1098,20,934,79,164,75
14000US06037574202,6037574202,"Census Tract 5742.02, Los Angeles, CA",737,30,325,52,412,58
14000US06037574300,6037574300,"Census Tract 5743, Los Angeles, CA",2249,36,1658,157,591,157
14000US06037574400,6037574400,"Census Tract 5744, Los Angeles, CA",1920,24,1577,90,343,92
14000US06037574500,6037574500,"Census Tract 5745, Los Angeles, CA",2267,53,2019,100,248,100
14000US06037574601,6037574601,"Census Tract 5746.01, Los Angeles, CA",0,12,0,12,0,12
14000US06037574602,6037574602,"Census Tract 5746.02, Los Angeles, CA",535,30,472,36,63,26
14000US06037574700,6037574700,"Census Tract 5747, Los Angeles, CA",0,12,0,12,0,12
14000US06037574800,6037574800,"Census Tract 5748, Los Angeles, CA",1496,67,724,97,772,101
14000US06037574901,6037574901,"Census Tract 5749.01, Los Angeles, CA",1358,60,1057,98,301,84
14000US06037574902,6037574902,"Census Tract 5749.02, Los Angeles, CA",1787,89,361,81,1426,110
14000US06037575001,6037575001,"Census Tract 5750.01, Los Angeles, CA",1696,76,592,116,1104,128
14000US06037575002,6037575002,"Census Tract 5750.02, Los Angeles, CA",1870,103,748,113,1122,133
14000US06037575101,6037575101,"Census Tract 5751.01, Los Angeles, CA",1458,74,300,80,1158,108
14000US06037575102,6037575102,"Census Tract 5751.02, Los Angeles, CA",1263,52,173,62,1090,85
14000US06037575103,6037575103,"Census Tract 5751.03, Los Angeles, CA",2039,66,323,88,1716,100
14000US06037575201,6037575201,"Census Tract 5752.01, Los Angeles, CA",1243,70,296,86,947,116
14000US06037575202,6037575202,"Census Tract 5752.02, Los Angeles, CA",1236,60,210,77,1026,86
14000US06037575300,6037575300,"Census Tract 5753, Los Angeles, CA",1306,93,165,67,1141,108
14000US06037575401,6037575401,"Census Tract 5754.01, Los Angeles, CA",1217,60,47,27,1170,66
14000US06037575402,6037575402,"Census Tract 5754.02, Los Angeles, CA",989,49,108,45,881,70
14000US06037575500,6037575500,"Census Tract 5755, Los Angeles, CA",41,27,0,12,41,27
14000US06037575801,6037575801,"Census Tract 5758.01, Los Angeles, CA",696,37,41,25,655,41
14000US06037575802,6037575802,"Census Tract 5758.02, Los Angeles, CA",1633,64,180,79,1453,96
14000US06037575803,6037575803,"Census Tract 5758.03, Los Angeles, CA",1289,61,161,62,1128,85
14000US06037575901,6037575901,"Census Tract 5759.01, Los Angeles, CA",1382,82,524,96,858,112
14000US06037575902,6037575902,"Census Tract 5759.02, Los Angeles, CA",2970,196,371,139,2599,205
14000US06037576001,6037576001,"Census Tract 5760.01, Los Angeles, CA",3238,271,1120,221,2118,287
14000US06037576200,6037576200,"Census Tract 5762, Los Angeles, CA",2976,126,445,148,2531,185
14000US06037576301,6037576301,"Census Tract 5763.01, Los Angeles, CA",1819,98,170,60,1649,120
14000US06037576302,6037576302,"Census Tract 5763.02, Los Angeles, CA",1224,56,108,57,1116,62
14000US06037576401,6037576401,"Census Tract 5764.01, Los Angeles, CA",1233,90,80,45,1153,90
14000US06037576402,6037576402,"Census Tract 5764.02, Los Angeles, CA",1348,77,298,91,1050,108
14000US06037576403,6037576403,"Census Tract 5764.03, Los Angeles, CA",1440,77,215,72,1225,99
14000US06037576501,6037576501,"Census Tract 5765.01, Los Angeles, CA",1429,88,120,55,1309,96
14000US06037576502,6037576502,"Census Tract 5765.02, Los Angeles, CA",1955,103,383,90,1572,134
14000US06037576503,6037576503,"Census Tract 5765.03, Los Angeles, CA",1908,62,245,69,1663,86
14000US06037576601,6037576601,"Census Tract 5766.01, Los Angeles, CA",2789,158,509,137,2280,201
14000US06037576602,6037576602,"Census Tract 5766.02, Los Angeles, CA",2584,180,526,146,2058,192
14000US06037576700,6037576700,"Census Tract 5767, Los Angeles, CA",2016,154,815,185,1201,193
14000US06037576801,6037576801,"Census Tract 5768.01, Los Angeles, CA",1926,185,416,127,1510,199
14000US06037576802,6037576802,"Census Tract 5768.02, Los Angeles, CA",1906,94,436,97,1470,115
14000US06037576901,6037576901,"Census Tract 5769.01, Los Angeles, CA",1775,90,162,57,1613,110
14000US06037576903,6037576903,"Census Tract 5769.03, Los Angeles, CA",1336,87,221,78,1115,106
14000US06037576904,6037576904,"Census Tract 5769.04, Los Angeles, CA",1273,49,324,101,949,119
14000US06037577000,6037577000,"Census Tract 5770, Los Angeles, CA",3259,136,805,207,2454,240
14000US06037577100,6037577100,"Census Tract 5771, Los Angeles, CA",3330,137,1045,197,2285,226
14000US06037577200,6037577200,"Census Tract 5772, Los Angeles, CA",3175,137,821,173,2354,191
14000US06037577300,6037577300,"Census Tract 5773, Los Angeles, CA",3167,158,726,142,2441,204
14000US06037577400,6037577400,"Census Tract 5774, Los Angeles, CA",1560,112,507,86,1053,113
14000US06037577501,6037577501,"Census Tract 5775.01, Los Angeles, CA",1710,64,1156,114,554,128
14000US06037577504,6037577504,"Census Tract 5775.04, Los Angeles, CA",770,61,312,61,458,70
14000US06037577602,6037577602,"Census Tract 5776.02, Los Angeles, CA",1616,111,1053,85,563,119
14000US06037577603,6037577603,"Census Tract 5776.03, Los Angeles, CA",3706,135,2599,195,1107,203
14000US06037577604,6037577604,"Census Tract 5776.04, Los Angeles, CA",774,47,630,60,144,53
14000US06037599000,6037599000,"Census Tract 5990, Los Angeles, CA",1471,171,405,132,1066,164
14000US06037599100,6037599100,"Census Tract 5991, Los Angeles, CA",82,52,18,22,64,48
14000US06037600100,6037600100,"Census Tract 6001, Los Angeles, CA",2180,77,361,117,1819,140
14000US06037600201,6037600201,"Census Tract 6002.01, Los Angeles, CA",1452,82,194,87,1258,109
14000US06037600202,6037600202,"Census Tract 6002.02, Los Angeles, CA",2201,91,580,121,1621,129
14000US06037600302,6037600302,"Census Tract 6003.02, Los Angeles, CA",1061,71,738,120,323,117
14000US06037600303,6037600303,"Census Tract 6003.03, Los Angeles, CA",1212,71,164,83,1048,101
14000US06037600304,6037600304,"Census Tract 6003.04, Los Angeles, CA",1115,52,189,40,926,67
14000US06037600400,6037600400,"Census Tract 6004, Los Angeles, CA",1542,90,847,140,695,142
14000US06037600501,6037600501,"Census Tract 6005.01, Los Angeles, CA",871,48,623,67,248,59
14000US06037600502,6037600502,"Census Tract 6005.02, Los Angeles, CA",635,30,447,62,188,58
14000US06037600601,6037600601,"Census Tract 6006.01, Los Angeles, CA",920,46,553,54,367,57
14000US06037600602,6037600602,"Census Tract 6006.02, Los Angeles, CA",696,43,38,24,658,49
14000US06037600702,6037600702,"Census Tract 6007.02, Los Angeles, CA",1402,64,1053,85,349,95
14000US06037600703,6037600703,"Census Tract 6007.03, Los Angeles, CA",874,65,712,77,162,52
14000US06037600704,6037600704,"Census Tract 6007.04, Los Angeles, CA",1215,72,535,80,680,97
14000US06037600801,6037600801,"Census Tract 6008.01, Los Angeles, CA",1232,65,1019,112,213,96
14000US06037600802,6037600802,"Census Tract 6008.02, Los Angeles, CA",1127,72,416,80,711,98
14000US06037600902,6037600902,"Census Tract 6009.02, Los Angeles, CA",2375,132,499,134,1876,171
14000US06037600911,6037600911,"Census Tract 6009.11, Los Angeles, CA",1124,56,557,84,567,92
14000US06037600912,6037600912,"Census Tract 6009.12, Los Angeles, CA",1447,78,681,102,766,128
14000US06037601001,6037601001,"Census Tract 6010.01, Los Angeles, CA",1072,58,147,62,925,76
14000US06037601002,6037601002,"Census Tract 6010.02, Los Angeles, CA",1894,144,402,135,1492,191
14000US06037601100,6037601100,"Census Tract 6011, Los Angeles, CA",2104,95,244,135,1860,165
14000US06037601202,6037601202,"Census Tract 6012.02, Los Angeles, CA",978,56,540,87,438,82
14000US06037601211,6037601211,"Census Tract 6012.11, Los Angeles, CA",1050,59,147,49,903,69
14000US06037601212,6037601212,"Census Tract 6012.12, Los Angeles, CA",2068,84,340,115,1728,146
14000US06037601301,6037601301,"Census Tract 6013.01, Los Angeles, CA",733,44,481,59,252,62
14000US06037601302,6037601302,"Census Tract 6013.02, Los Angeles, CA",2795,144,458,127,2337,178
14000US06037601303,6037601303,"Census Tract 6013.03, Los Angeles, CA",2075,88,306,81,1769,119
14000US06037601401,6037601401,"Census Tract 6014.01, Los Angeles, CA",1728,92,463,94,1265,123
14000US06037601402,6037601402,"Census Tract 6014.02, Los Angeles, CA",1287,58,777,111,510,116
14000US06037601501,6037601501,"Census Tract 6015.01, Los Angeles, CA",1084,51,194,44,890,61
14000US06037601502,6037601502,"Census Tract 6015.02, Los Angeles, CA",872,50,224,63,648,82
14000US06037601600,6037601600,"Census Tract 6016, Los Angeles, CA",1057,69,405,90,652,109
14000US06037601700,6037601700,"Census Tract 6017, Los Angeles, CA",1303,75,316,78,987,97
14000US06037601801,6037601801,"Census Tract 6018.01, Los Angeles, CA",802,52,297,66,505,70
14000US06037601802,6037601802,"Census Tract 6018.02, Los Angeles, CA",998,52,331,96,667,105
14000US06037601900,6037601900,"Census Tract 6019, Los Angeles, CA",1238,66,288,83,950,108
14000US06037602002,6037602002,"Census Tract 6020.02, Los Angeles, CA",809,45,295,42,514,60
14000US06037602003,6037602003,"Census Tract 6020.03, Los Angeles, CA",1258,59,439,101,819,110
14000US06037602004,6037602004,"Census Tract 6020.04, Los Angeles, CA",1052,40,463,88,589,89
14000US06037602103,6037602103,"Census Tract 6021.03, Los Angeles, CA",2090,132,402,145,1688,181
14000US06037602104,6037602104,"Census Tract 6021.04, Los Angeles, CA",1739,50,366,103,1373,118
14000US06037602105,6037602105,"Census Tract 6021.05, Los Angeles, CA",1248,90,274,64,974,109
14000US06037602106,6037602106,"Census Tract 6021.06, Los Angeles, CA",2001,117,373,112,1628,157
14000US06037602200,6037602200,"Census Tract 6022, Los Angeles, CA",2577,168,1126,184,1451,201
14000US06037602301,6037602301,"Census Tract 6023.01, Los Angeles, CA",1886,96,1316,155,570,149
14000US06037602302,6037602302,"Census Tract 6023.02, Los Angeles, CA",1844,97,1569,132,275,96
14000US06037602402,6037602402,"Census Tract 6024.02, Los Angeles, CA",2085,100,1071,154,1014,161
14000US06037602403,6037602403,"Census Tract 6024.03, Los Angeles, CA",1666,71,239,78,1427,101
14000US06037602404,6037602404,"Census Tract 6024.04, Los Angeles, CA",1818,94,257,80,1561,129
14000US06037602504,6037602504,"Census Tract 6025.04, Los Angeles, CA",1748,72,129,51,1619,87
14000US06037602505,6037602505,"Census Tract 6025.05, Los Angeles, CA",1660,79,74,40,1586,83
14000US06037602506,6037602506,"Census Tract 6025.06, Los Angeles, CA",1721,92,165,54,1556,97
14000US06037602507,6037602507,"Census Tract 6025.07, Los Angeles, CA",1835,73,191,67,1644,93
14000US06037602508,6037602508,"Census Tract 6025.08, Los Angeles, CA",2383,105,285,96,2098,142
14000US06037602509,6037602509,"Census Tract 6025.09, Los Angeles, CA",1141,47,380,95,761,94
14000US06037602600,6037602600,"Census Tract 6026, Los Angeles, CA",2881,91,1789,188,1092,161
14000US06037602700,6037602700,"Census Tract 6027, Los Angeles, CA",1276,73,1003,89,273,93
14000US06037602801,6037602801,"Census Tract 6028.01, Los Angeles, CA",1247,78,423,86,824,88
14000US06037602802,6037602802,"Census Tract 6028.02, Los Angeles, CA",1399,41,1153,102,246,102
14000US06037602900,6037602900,"Census Tract 6029, Los Angeles, CA",1316,48,690,105,626,105
14000US06037603001,6037603001,"Census Tract 6030.01, Los Angeles, CA",2421,111,791,155,1630,173
14000US06037603004,6037603004,"Census Tract 6030.04, Los Angeles, CA",634,41,163,36,471,45
14000US06037603005,6037603005,"Census Tract 6030.05, Los Angeles, CA",1872,83,542,106,1330,134
14000US06037603006,6037603006,"Census Tract 6030.06, Los Angeles, CA",810,39,312,49,498,52
14000US06037603101,6037603101,"Census Tract 6031.01, Los Angeles, CA",1481,70,582,92,899,117
14000US06037603102,6037603102,"Census Tract 6031.02, Los Angeles, CA",1318,83,416,98,902,115
14000US06037603200,6037603200,"Census Tract 6032, Los Angeles, CA",1163,60,836,97,327,96
14000US06037603301,6037603301,"Census Tract 6033.01, Los Angeles, CA",1418,107,407,104,1011,130
14000US06037603302,6037603302,"Census Tract 6033.02, Los Angeles, CA",1630,65,836,121,794,115
14000US06037603400,6037603400,"Census Tract 6034, Los Angeles, CA",1421,77,823,113,598,118
14000US06037603500,6037603500,"Census Tract 6035, Los Angeles, CA",883,47,743,55,140,42
14000US06037603600,6037603600,"Census Tract 6036, Los Angeles, CA",1364,61,947,114,417,127
14000US06037603702,6037603702,"Census Tract 6037.02, Los Angeles, CA",1510,78,1275,105,235,88
14000US06037603703,6037603703,"Census Tract 6037.03, Los Angeles, CA",806,36,710,45,96,41
14000US06037603704,6037603704,"Census Tract 6037.04, Los Angeles, CA",2112,111,344,124,1768,147
14000US06037603801,6037603801,"Census Tract 6038.01, Los Angeles, CA",1500,94,328,83,1172,119
14000US06037603802,6037603802,"Census Tract 6038.02, Los Angeles, CA",1154,53,454,91,700,102
14000US06037603900,6037603900,"Census Tract 6039, Los Angeles, CA",2423,132,965,201,1458,189
14000US06037604001,6037604001,"Census Tract 6040.01, Los Angeles, CA",1296,80,481,104,815,124
14000US06037604002,6037604002,"Census Tract 6040.02, Los Angeles, CA",1511,116,450,97,1061,142
14000US06037604100,6037604100,"Census Tract 6041, Los Angeles, CA",2018,92,722,182,1296,175
14000US06037609900,6037609900,"Census Tract 6099, Los Angeles, CA",582,40,261,51,321,64
14000US06037620001,6037620001,"Census Tract 6200.01, Los Angeles, CA",1400,85,679,79,721,112
14000US06037620002,6037620002,"Census Tract 6200.02, Los Angeles, CA",1449,82,455,80,994,102
14000US06037620101,6037620101,"Census Tract 6201.01, Los Angeles, CA",2115,114,1183,149,932,150
14000US06037620102,6037620102,"Census Tract 6201.02, Los Angeles, CA",1453,103,475,73,978,107
14000US06037620201,6037620201,"Census Tract 6202.01, Los Angeles, CA",927,63,260,70,667,85
14000US06037620301,6037620301,"Census Tract 6203.01, Los Angeles, CA",1634,89,1332,103,302,89
14000US06037620303,6037620303,"Census Tract 6203.03, Los Angeles, CA",1553,130,1254,112,299,77
14000US06037620305,6037620305,"Census Tract 6203.05, Los Angeles, CA",2430,193,1381,169,1049,188
14000US06037620400,6037620400,"Census Tract 6204, Los Angeles, CA",2041,110,1503,156,538,158
14000US06037620501,6037620501,"Census Tract 6205.01, Los Angeles, CA",2085,86,1161,157,924,162
14000US06037620521,6037620521,"Census Tract 6205.21, Los Angeles, CA",1547,87,693,120,854,121
14000US06037620522,6037620522,"Census Tract 6205.22, Los Angeles, CA",1822,102,907,124,915,116
14000US06037620601,6037620601,"Census Tract 6206.01, Los Angeles, CA",2201,148,1014,165,1187,197
14000US06037620602,6037620602,"Census Tract 6206.02, Los Angeles, CA",1931,136,1533,158,398,122
14000US06037620701,6037620701,"Census Tract 6207.01, Los Angeles, CA",2820,126,1724,229,1096,229
14000US06037620702,6037620702,"Census Tract 6207.02, Los Angeles, CA",2551,107,1824,180,727,172
14000US06037620800,6037620800,"Census Tract 6208, Los Angeles, CA",2717,118,2068,165,649,136
14000US06037620901,6037620901,"Census Tract 6209.01, Los Angeles, CA",968,55,802,65,166,50
14000US06037620904,6037620904,"Census Tract 6209.04, Los Angeles, CA",1157,103,744,97,413,96
14000US06037621001,6037621001,"Census Tract 6210.01, Los Angeles, CA",1883,114,1072,109,811,117
14000US06037621002,6037621002,"Census Tract 6210.02, Los Angeles, CA",481,69,197,44,284,65
14000US06037621004,6037621004,"Census Tract 6210.04, Los Angeles, CA",2093,179,918,160,1175,230
14000US06037621102,6037621102,"Census Tract 6211.02, Los Angeles, CA",1199,88,818,104,381,91
14000US06037621104,6037621104,"Census Tract 6211.04, Los Angeles, CA",3300,195,1240,205,2060,228
14000US06037621201,6037621201,"Census Tract 6212.01, Los Angeles, CA",2489,142,1422,174,1067,166
14000US06037621204,6037621204,"Census Tract 6212.04, Los Angeles, CA",1815,106,566,90,1249,124
14000US06037621301,6037621301,"Census Tract 6213.01, Los Angeles, CA",2750,189,1440,212,1310,215
14000US06037621324,6037621324,"Census Tract 6213.24, Los Angeles, CA",2049,148,658,112,1391,178
14000US06037621326,6037621326,"Census Tract 6213.26, Los Angeles, CA",1726,126,419,93,1307,144
14000US06037621400,6037621400,"Census Tract 6214, Los Angeles, CA",1877,99,1004,106,873,114
14000US06037650001,6037650001,"Census Tract 6500.01, Los Angeles, CA",2094,135,1406,171,688,181
14000US06037650003,6037650003,"Census Tract 6500.03, Los Angeles, CA",1163,82,371,81,792,119
14000US06037650004,6037650004,"Census Tract 6500.04, Los Angeles, CA",1529,95,731,90,798,105
14000US06037650101,6037650101,"Census Tract 6501.01, Los Angeles, CA",2095,108,1653,178,442,152
14000US06037650102,6037650102,"Census Tract 6501.02, Los Angeles, CA",755,39,591,51,164,50
14000US06037650200,6037650200,"Census Tract 6502, Los Angeles, CA",1895,64,1484,89,411,91
14000US06037650300,6037650300,"Census Tract 6503, Los Angeles, CA",2520,131,1183,206,1337,199
14000US06037650401,6037650401,"Census Tract 6504.01, Los Angeles, CA",1468,68,1132,96,336,86
14000US06037650501,6037650501,"Census Tract 6505.01, Los Angeles, CA",1043,37,915,64,128,43
14000US06037650502,6037650502,"Census Tract 6505.02, Los Angeles, CA",1478,78,1018,107,460,103
14000US06037650602,6037650602,"Census Tract 6506.02, Los Angeles, CA",2726,199,565,107,2161,191
14000US06037650603,6037650603,"Census Tract 6506.03, Los Angeles, CA",1492,72,878,77,614,89
14000US06037650604,6037650604,"Census Tract 6506.04, Los Angeles, CA",2419,128,128,60,2291,144
14000US06037650605,6037650605,"Census Tract 6506.05, Los Angeles, CA",1120,53,342,62,778,67
14000US06037650701,6037650701,"Census Tract 6507.01, Los Angeles, CA",972,51,801,60,171,43
14000US06037650702,6037650702,"Census Tract 6507.02, Los Angeles, CA",1550,55,1352,79,198,65
14000US06037650800,6037650800,"Census Tract 6508, Los Angeles, CA",2758,197,1626,208,1132,218
14000US06037650901,6037650901,"Census Tract 6509.01, Los Angeles, CA",2342,180,1112,208,1230,197
14000US06037650902,6037650902,"Census Tract 6509.02, Los Angeles, CA",2629,151,1266,176,1363,226
14000US06037651001,6037651001,"Census Tract 6510.01, Los Angeles, CA",1799,97,1353,133,446,111
14000US06037651002,6037651002,"Census Tract 6510.02, Los Angeles, CA",1703,82,1066,94,637,107
14000US06037651101,6037651101,"Census Tract 6511.01, Los Angeles, CA",1850,85,1045,112,805,118
14000US06037651102,6037651102,"Census Tract 6511.02, Los Angeles, CA",1645,97,789,101,856,115
14000US06037651201,6037651201,"Census Tract 6512.01, Los Angeles, CA",1634,72,1498,84,136,67
14000US06037651221,6037651221,"Census Tract 6512.21, Los Angeles, CA",1395,64,413,68,982,93
14000US06037651222,6037651222,"Census Tract 6512.22, Los Angeles, CA",2329,118,691,129,1638,173
14000US06037651302,6037651302,"Census Tract 6513.02, Los Angeles, CA",2287,134,1715,163,572,125
14000US06037651304,6037651304,"Census Tract 6513.04, Los Angeles, CA",2327,128,1152,170,1175,180
14000US06037651401,6037651401,"Census Tract 6514.01, Los Angeles, CA",1127,62,751,82,376,81
14000US06037651402,6037651402,"Census Tract 6514.02, Los Angeles, CA",2293,79,1392,213,901,215
14000US06037670001,6037670001,"Census Tract 6700.01, Los Angeles, CA",1335,90,865,109,470,96
14000US06037670002,6037670002,"Census Tract 6700.02, Los Angeles, CA",1463,81,613,107,850,116
14000US06037670003,6037670003,"Census Tract 6700.03, Los Angeles, CA",2266,165,1146,190,1120,188
14000US06037670100,6037670100,"Census Tract 6701, Los Angeles, CA",2748,154,1058,199,1690,224
14000US06037670201,6037670201,"Census Tract 6702.01, Los Angeles, CA",1441,84,1174,98,267,84
14000US06037670202,6037670202,"Census Tract 6702.02, Los Angeles, CA",889,52,846,56,43,38
14000US06037670324,6037670324,"Census Tract 6703.24, Los Angeles, CA",1852,136,1600,143,252,86
14000US06037670326,6037670326,"Census Tract 6703.26, Los Angeles, CA",1338,82,1197,104,141,69
14000US06037670328,6037670328,"Census Tract 6703.28, Los Angeles, CA",1719,90,1435,111,284,79
14000US06037670403,6037670403,"Census Tract 6704.03, Los Angeles, CA",992,48,892,56,100,41
14000US06037670405,6037670405,"Census Tract 6704.05, Los Angeles, CA",1127,79,885,92,242,73
14000US06037670406,6037670406,"Census Tract 6704.06, Los Angeles, CA",660,46,629,52,31,22
14000US06037670407,6037670407,"Census Tract 6704.07, Los Angeles, CA",2345,94,1181,202,1164,208
14000US06037670411,6037670411,"Census Tract 6704.11, Los Angeles, CA",1539,100,1370,118,169,66
14000US06037670413,6037670413,"Census Tract 6704.13, Los Angeles, CA",1710,118,1359,113,351,94
14000US06037670416,6037670416,"Census Tract 6704.16, Los Angeles, CA",1661,87,1030,111,631,100
14000US06037670500,6037670500,"Census Tract 6705, Los Angeles, CA",577,46,550,43,27,15
14000US06037670602,6037670602,"Census Tract 6706.02, Los Angeles, CA",2579,203,2156,194,423,131
14000US06037670701,6037670701,"Census Tract 6707.01, Los Angeles, CA",2497,111,2053,169,444,162
14000US06037670702,6037670702,"Census Tract 6707.02, Los Angeles, CA",2021,114,1899,139,122,82
14000US06037700101,6037700101,"Census Tract 7001.01, Los Angeles, CA",3506,230,146,96,3360,240
14000US06037700102,6037700102,"Census Tract 7001.02, Los Angeles, CA",2785,179,91,60,2694,187
14000US06037700200,6037700200,"Census Tract 7002, Los Angeles, CA",4541,249,526,191,4015,299
14000US06037700300,6037700300,"Census Tract 7003, Los Angeles, CA",4033,209,970,198,3063,243
14000US06037700400,6037700400,"Census Tract 7004, Los Angeles, CA",3173,208,906,186,2267,262
14000US06037700501,6037700501,"Census Tract 7005.01, Los Angeles, CA",2351,223,898,191,1453,242
14000US06037700502,6037700502,"Census Tract 7005.02, Los Angeles, CA",2980,224,930,192,2050,233
14000US06037700600,6037700600,"Census Tract 7006, Los Angeles, CA",1728,128,1609,139,119,67
14000US06037700700,6037700700,"Census Tract 7007, Los Angeles, CA",1131,111,1043,115,88,75
14000US06037700801,6037700801,"Census Tract 7008.01, Los Angeles, CA",2446,246,823,196,1623,247
14000US06037700802,6037700802,"Census Tract 7008.02, Los Angeles, CA",1924,150,387,86,1537,153
14000US06037700901,6037700901,"Census Tract 7009.01, Los Angeles, CA",1554,125,700,103,854,138
14000US06037700902,6037700902,"Census Tract 7009.02, Los Angeles, CA",3334,252,665,156,2669,270
14000US06037701000,6037701000,"Census Tract 7010, Los Angeles, CA",2652,192,901,192,1751,265
14000US06037701100,6037701100,"Census Tract 7011, Los Angeles, CA",48,29,17,15,31,27
14000US06037701201,6037701201,"Census Tract 7012.01, Los Angeles, CA",1437,92,1295,97,142,59
14000US06037701202,6037701202,"Census Tract 7012.02, Los Angeles, CA",1684,107,567,95,1117,118
14000US06037701302,6037701302,"Census Tract 7013.02, Los Angeles, CA",2775,173,510,170,2265,210
14000US06037701304,6037701304,"Census Tract 7013.04, Los Angeles, CA",3012,198,1557,186,1455,209
14000US06037701402,6037701402,"Census Tract 7014.02, Los Angeles, CA",3558,343,428,201,3130,371
14000US06037701501,6037701501,"Census Tract 7015.01, Los Angeles, CA",2669,152,510,152,2159,192
14000US06037701502,6037701502,"Census Tract 7015.02, Los Angeles, CA",1731,119,352,101,1379,143
14000US06037701601,6037701601,"Census Tract 7016.01, Los Angeles, CA",1730,109,963,120,767,147
14000US06037701602,6037701602,"Census Tract 7016.02, Los Angeles, CA",1874,144,613,146,1261,203
14000US06037701701,6037701701,"Census Tract 7017.01, Los Angeles, CA",1742,113,465,100,1277,149
14000US06037701702,6037701702,"Census Tract 7017.02, Los Angeles, CA",1808,130,214,99,1594,140
14000US06037701801,6037701801,"Census Tract 7018.01, Los Angeles, CA",2771,175,489,121,2282,182
14000US06037701802,6037701802,"Census Tract 7018.02, Los Angeles, CA",1803,93,327,77,1476,110
14000US06037701902,6037701902,"Census Tract 7019.02, Los Angeles, CA",3054,231,124,81,2930,230
14000US06037702002,6037702002,"Census Tract 7020.02, Los Angeles, CA",3465,206,828,163,2637,253
14000US06037702102,6037702102,"Census Tract 7021.02, Los Angeles, CA",3677,215,768,175,2909,274
14000US06037702201,6037702201,"Census Tract 7022.01, Los Angeles, CA",2044,127,801,150,1243,178
14000US06037702202,6037702202,"Census Tract 7022.02, Los Angeles, CA",1658,82,885,88,773,118
14000US06037702300,6037702300,"Census Tract 7023, Los Angeles, CA",2817,164,1442,181,1375,210
14000US06037702400,6037702400,"Census Tract 7024, Los Angeles, CA",1965,99,554,98,1411,118
14000US06037702501,6037702501,"Census Tract 7025.01, Los Angeles, CA",1996,135,1096,171,900,192
14000US06037702502,6037702502,"Census Tract 7025.02, Los Angeles, CA",2016,109,1255,220,761,241
14000US06037702600,6037702600,"Census Tract 7026, Los Angeles, CA",2327,74,1771,160,556,147
14000US06037702700,6037702700,"Census Tract 7027, Los Angeles, CA",1271,67,950,81,321,80
14000US06037702801,6037702801,"Census Tract 7028.01, Los Angeles, CA",2048,142,737,152,1311,184
14000US06037702802,6037702802,"Census Tract 7028.02, Los Angeles, CA",887,46,460,49,427,57
14000US06037702803,6037702803,"Census Tract 7028.03, Los Angeles, CA",1222,63,356,92,866,104
14000US06037702901,6037702901,"Census Tract 7029.01, Los Angeles, CA",5537,446,316,136,5221,456
14000US06037703001,6037703001,"Census Tract 7030.01, Los Angeles, CA",3158,149,1658,220,1500,239
14000US06037703002,6037703002,"Census Tract 7030.02, Los Angeles, CA",2859,150,2115,160,744,151
14000US06037703100,6037703100,"Census Tract 7031, Los Angeles, CA",2519,111,1793,180,726,174
14000US06037703200,6037703200,"Census Tract 7032, Los Angeles, CA",2315,141,1844,208,471,172
14000US06037800101,6037800101,"Census Tract 8001.01, Los Angeles, CA",1938,98,1764,135,174,83
14000US06037800102,6037800102,"Census Tract 8001.02, Los Angeles, CA",2688,188,1946,207,742,212
14000US06037800202,6037800202,"Census Tract 8002.02, Los Angeles, CA",2049,89,1785,148,264,129
14000US06037800203,6037800203,"Census Tract 8002.03, Los Angeles, CA",1953,86,1387,113,566,97
14000US06037800204,6037800204,"Census Tract 8002.04, Los Angeles, CA",1726,122,1328,171,398,151
14000US06037800324,6037800324,"Census Tract 8003.24, Los Angeles, CA",2441,129,2160,136,281,133
14000US06037800325,6037800325,"Census Tract 8003.25, Los Angeles, CA",1507,94,1227,123,280,91
14000US06037800326,6037800326,"Census Tract 8003.26, Los Angeles, CA",1832,109,1536,114,296,97
14000US06037800327,6037800327,"Census Tract 8003.27, Los Angeles, CA",2190,131,1226,207,964,185
14000US06037800328,6037800328,"Census Tract 8003.28, Los Angeles, CA",975,87,498,96,477,95
14000US06037800329,6037800329,"Census Tract 8003.29, Los Angeles, CA",2591,123,1628,171,963,163
14000US06037800330,6037800330,"Census Tract 8003.30, Los Angeles, CA",327,42,277,44,50,33
14000US06037800331,6037800331,"Census Tract 8003.31, Los Angeles, CA",217,42,158,37,59,30
14000US06037800332,6037800332,"Census Tract 8003.32, Los Angeles, CA",2265,121,2051,172,214,136
14000US06037800406,6037800406,"Census Tract 8004.06, Los Angeles, CA",981,126,711,117,270,94
14000US06037800408,6037800408,"Census Tract 8004.08, Los Angeles, CA",3133,230,2685,267,448,177
14000US06037800410,6037800410,"Census Tract 8004.10, Los Angeles, CA",592,68,458,65,134,51
14000US06037800504,6037800504,"Census Tract 8005.04, Los Angeles, CA",1150,157,734,167,416,143
14000US06037800506,6037800506,"Census Tract 8005.06, Los Angeles, CA",1384,138,1082,114,302,113
14000US06037900102,6037900102,"Census Tract 9001.02, Los Angeles, CA",274,47,175,50,99,41
14000US06037900103,6037900103,"Census Tract 9001.03, Los Angeles, CA",1672,117,984,130,688,182
14000US06037900104,6037900104,"Census Tract 9001.04, Los Angeles, CA",1697,104,1277,150,420,127
14000US06037900201,6037900201,"Census Tract 9002.01, Los Angeles, CA",421,53,332,61,89,42
14000US06037900300,6037900300,"Census Tract 9003, Los Angeles, CA",1226,75,767,99,459,105
14000US06037900501,6037900501,"Census Tract 9005.01, Los Angeles, CA",1969,116,1038,189,931,202
14000US06037900504,6037900504,"Census Tract 9005.04, Los Angeles, CA",2007,89,1243,125,764,140
14000US06037900505,6037900505,"Census Tract 9005.05, Los Angeles, CA",1142,103,663,90,479,125
14000US06037900506,6037900506,"Census Tract 9005.06, Los Angeles, CA",1282,97,667,101,615,130
14000US06037900507,6037900507,"Census Tract 9005.07, Los Angeles, CA",2266,108,1191,148,1075,167
14000US06037900508,6037900508,"Census Tract 9005.08, Los Angeles, CA",1049,49,630,77,419,82
14000US06037900602,6037900602,"Census Tract 9006.02, Los Angeles, CA",1556,105,933,152,623,121
14000US06037900605,6037900605,"Census Tract 9006.05, Los Angeles, CA",2215,119,1398,240,817,200
14000US06037900606,6037900606,"Census Tract 9006.06, Los Angeles, CA",1115,99,342,97,773,138
14000US06037900607,6037900607,"Census Tract 9006.07, Los Angeles, CA",1160,90,568,109,592,130
14000US06037900608,6037900608,"Census Tract 9006.08, Los Angeles, CA",984,75,575,110,409,107
14000US06037900609,6037900609,"Census Tract 9006.09, Los Angeles, CA",1464,131,643,135,821,129
14000US06037900701,6037900701,"Census Tract 9007.01, Los Angeles, CA",1715,101,624,115,1091,153
14000US06037900703,6037900703,"Census Tract 9007.03, Los Angeles, CA",1750,98,380,99,1370,139
14000US06037900704,6037900704,"Census Tract 9007.04, Los Angeles, CA",1423,72,35,35,1388,79
14000US06037900705,6037900705,"Census Tract 9007.05, Los Angeles, CA",1731,147,639,141,1092,149
14000US06037900803,6037900803,"Census Tract 9008.03, Los Angeles, CA",2428,136,1379,177,1049,210
14000US06037900804,6037900804,"Census Tract 9008.04, Los Angeles, CA",1071,42,507,78,564,88
14000US06037900805,6037900805,"Census Tract 9008.05, Los Angeles, CA",1393,127,938,135,455,133
14000US06037900806,6037900806,"Census Tract 9008.06, Los Angeles, CA",2029,108,212,70,1817,124
14000US06037900900,6037900900,"Census Tract 9009, Los Angeles, CA",1405,96,1016,129,389,115
14000US06037901003,6037901003,"Census Tract 9010.03, Los Angeles, CA",0,12,0,12,0,12
14000US06037901004,6037901004,"Census Tract 9010.04, Los Angeles, CA",3745,167,2797,234,948,194
14000US06037901007,6037901007,"Census Tract 9010.07, Los Angeles, CA",637,59,454,66,183,65
14000US06037901008,6037901008,"Census Tract 9010.08, Los Angeles, CA",908,47,422,67,486,75
14000US06037901009,6037901009,"Census Tract 9010.09, Los Angeles, CA",1819,98,1196,112,623,130
14000US06037901010,6037901010,"Census Tract 9010.10, Los Angeles, CA",1814,100,1008,131,806,118
14000US06037901011,6037901011,"Census Tract 9010.11, Los Angeles, CA",1988,59,929,136,1059,124
14000US06037901101,6037901101,"Census Tract 9011.01, Los Angeles, CA",1735,103,1133,145,602,141
14000US06037901102,6037901102,"Census Tract 9011.02, Los Angeles, CA",1829,88,1276,119,553,129
14000US06037901205,6037901205,"Census Tract 9012.05, Los Angeles, CA",3720,132,2338,208,1382,221
14000US06037901209,6037901209,"Census Tract 9012.09, Los Angeles, CA",566,80,426,72,140,67
14000US06037901210,6037901210,"Census Tract 9012.10, Los Angeles, CA",639,50,496,64,143,60
14000US06037901213,6037901213,"Census Tract 9012.13, Los Angeles, CA",1260,70,1168,75,92,47
14000US06037910001,6037910001,"Census Tract 9100.01, Los Angeles, CA",1583,67,1091,118,492,128
14000US06037910002,6037910002,"Census Tract 9100.02, Los Angeles, CA",1984,154,1321,186,663,213
14000US06037910101,6037910101,"Census Tract 9101.01, Los Angeles, CA",446,35,197,38,249,44
14000US06037910201,6037910201,"Census Tract 9102.01, Los Angeles, CA",1364,71,818,141,546,138
14000US06037910202,6037910202,"Census Tract 9102.02, Los Angeles, CA",1594,97,1438,118,156,86
14000US06037910205,6037910205,"Census Tract 9102.05, Los Angeles, CA",418,56,335,66,83,44
14000US06037910206,6037910206,"Census Tract 9102.06, Los Angeles, CA",1057,50,883,78,174,65
14000US06037910207,6037910207,"Census Tract 9102.07, Los Angeles, CA",1695,64,1301,133,394,117
14000US06037910208,6037910208,"Census Tract 9102.08, Los Angeles, CA",1890,91,1288,141,602,129
14000US06037910209,6037910209,"Census Tract 9102.09, Los Angeles, CA",1356,57,1112,100,244,85
14000US06037910210,6037910210,"Census Tract 9102.10, Los Angeles, CA",2125,142,1730,195,395,160
14000US06037910301,6037910301,"Census Tract 9103.01, Los Angeles, CA",1413,84,1219,104,194,82
14000US06037910302,6037910302,"Census Tract 9103.02, Los Angeles, CA",1953,105,1512,160,441,154
14000US06037910401,6037910401,"Census Tract 9104.01, Los Angeles, CA",2167,119,1348,192,819,196
14000US06037910402,6037910402,"Census Tract 9104.02, Los Angeles, CA",1007,57,288,51,719,70
14000US06037910403,6037910403,"Census Tract 9104.03, Los Angeles, CA",562,54,45,25,517,56
14000US06037910404,6037910404,"Census Tract 9104.04, Los Angeles, CA",1075,70,621,104,454,106
14000US06037910501,6037910501,"Census Tract 9105.01, Los Angeles, CA",2004,125,46,33,1958,131
14000US06037910502,6037910502,"Census Tract 9105.02, Los Angeles, CA",1181,63,379,91,802,108
14000US06037910504,6037910504,"Census Tract 9105.04, Los Angeles, CA",1186,71,737,126,449,124
14000US06037910505,6037910505,"Census Tract 9105.05, Los Angeles, CA",814,59,652,70,162,74
14000US06037910601,6037910601,"Census Tract 9106.01, Los Angeles, CA",1564,111,1121,138,443,138
14000US06037910602,6037910602,"Census Tract 9106.02, Los Angeles, CA",1357,73,557,102,800,110
14000US06037910603,6037910603,"Census Tract 9106.03, Los Angeles, CA",2022,76,1157,147,865,159
14000US06037910605,6037910605,"Census Tract 9106.05, Los Angeles, CA",1229,68,762,130,467,118
14000US06037910606,6037910606,"Census Tract 9106.06, Los Angeles, CA",795,32,521,70,274,67
14000US06037910705,6037910705,"Census Tract 9107.05, Los Angeles, CA",2717,189,2257,179,460,163
14000US06037910706,6037910706,"Census Tract 9107.06, Los Angeles, CA",1473,73,1052,134,421,143
14000US06037910707,6037910707,"Census Tract 9107.07, Los Angeles, CA",1517,63,858,96,659,100
14000US06037910709,6037910709,"Census Tract 9107.09, Los Angeles, CA",532,14,485,39,47,41
14000US06037910711,6037910711,"Census Tract 9107.11, Los Angeles, CA",2199,110,1672,197,527,187
14000US06037910712,6037910712,"Census Tract 9107.12, Los Angeles, CA",627,54,504,60,123,55
14000US06037910713,6037910713,"Census Tract 9107.13, Los Angeles, CA",1416,64,1166,94,250,84
14000US06037910714,6037910714,"Census Tract 9107.14, Los Angeles, CA",901,37,589,87,312,85
14000US06037910715,6037910715,"Census Tract 9107.15, Los Angeles, CA",1880,100,1294,167,586,150
14000US06037910716,6037910716,"Census Tract 9107.16, Los Angeles, CA",1685,59,1205,124,480,122
14000US06037910804,6037910804,"Census Tract 9108.04, Los Angeles, CA",1069,95,960,100,109,62
14000US06037910805,6037910805,"Census Tract 9108.05, Los Angeles, CA",1554,105,1405,111,149,86
14000US06037910807,6037910807,"Census Tract 9108.07, Los Angeles, CA",1931,73,1447,122,484,119
14000US06037910808,6037910808,"Census Tract 9108.08, Los Angeles, CA",1076,21,1021,44,55,40
14000US06037910809,6037910809,"Census Tract 9108.09, Los Angeles, CA",711,33,685,43,26,29
14000US06037910810,6037910810,"Census Tract 9108.10, Los Angeles, CA",716,54,645,64,71,56
14000US06037910811,6037910811,"Census Tract 9108.11, Los Angeles, CA",41,26,41,26,0,12
14000US06037910812,6037910812,"Census Tract 9108.12, Los Angeles, CA",139,39,118,38,21,18
14000US06037910813,6037910813,"Census Tract 9108.13, Los Angeles, CA",1265,81,1205,86,60,41
14000US06037911001,6037911001,"Census Tract 9110.01, Los Angeles, CA",1516,148,1151,172,365,157
14000US06037920011,6037920011,"Census Tract 9200.11, Los Angeles, CA",47,18,35,15,12,10
14000US06037920012,6037920012,"Census Tract 9200.12, Los Angeles, CA",464,39,332,52,132,49
14000US06037920013,6037920013,"Census Tract 9200.13, Los Angeles, CA",2225,73,2050,99,175,81
14000US06037920015,6037920015,"Census Tract 9200.15, Los Angeles, CA",2012,56,1865,88,147,71
14000US06037920016,6037920016,"Census Tract 9200.16, Los Angeles, CA",1171,29,1072,61,99,57
14000US06037920017,6037920017,"Census Tract 9200.17, Los Angeles, CA",1251,76,1006,106,245,88
14000US06037920018,6037920018,"Census Tract 9200.18, Los Angeles, CA",696,24,606,44,90,37
14000US06037920020,6037920020,"Census Tract 9200.20, Los Angeles, CA",1976,96,1813,114,163,74
14000US06037920023,6037920023,"Census Tract 9200.23, Los Angeles, CA",733,28,647,50,86,42
14000US06037920026,6037920026,"Census Tract 9200.26, Los Angeles, CA",101,21,87,20,14,11
14000US06037920028,6037920028,"Census Tract 9200.28, Los Angeles, CA",2114,57,1801,99,313,99
14000US06037920029,6037920029,"Census Tract 9200.29, Los Angeles, CA",1855,77,1058,99,797,90
14000US06037920030,6037920030,"Census Tract 9200.30, Los Angeles, CA",1690,49,1430,105,260,99
14000US06037920031,6037920031,"Census Tract 9200.31, Los Angeles, CA",1994,73,1775,108,219,105
14000US06037920032,6037920032,"Census Tract 9200.32, Los Angeles, CA",1031,74,981,81,50,31
14000US06037920033,6037920033,"Census Tract 9200.33, Los Angeles, CA",156,48,136,47,20,22
14000US06037920034,6037920034,"Census Tract 9200.34, Los Angeles, CA",1084,71,859,85,225,84
14000US06037920035,6037920035,"Census Tract 9200.35, Los Angeles, CA",2127,88,1690,170,437,174
14000US06037920036,6037920036,"Census Tract 9200.36, Los Angeles, CA",928,20,596,76,332,73
14000US06037920037,6037920037,"Census Tract 9200.37, Los Angeles, CA",3102,173,975,202,2127,249
14000US06037920038,6037920038,"Census Tract 9200.38, Los Angeles, CA",614,50,164,84,450,83
14000US06037920039,6037920039,"Census Tract 9200.39, Los Angeles, CA",638,34,472,49,166,53
14000US06037920040,6037920040,"Census Tract 9200.40, Los Angeles, CA",1241,55,845,64,396,67
14000US06037920041,6037920041,"Census Tract 9200.41, Los Angeles, CA",460,33,182,48,278,57
14000US06037920042,6037920042,"Census Tract 9200.42, Los Angeles, CA",2336,96,1341,167,995,155
14000US06037920043,6037920043,"Census Tract 9200.43, Los Angeles, CA",2018,95,1695,98,323,106
14000US06037920044,6037920044,"Census Tract 9200.44, Los Angeles, CA",832,44,741,51,91,39
14000US06037920045,6037920045,"Census Tract 9200.45, Los Angeles, CA",1342,29,1192,74,150,63
14000US06037920102,6037920102,"Census Tract 9201.02, Los Angeles, CA",1806,112,1017,140,789,154
14000US06037920104,6037920104,"Census Tract 9201.04, Los Angeles, CA",850,36,801,52,49,33
14000US06037920106,6037920106,"Census Tract 9201.06, Los Angeles, CA",915,47,763,69,152,62
14000US06037920107,6037920107,"Census Tract 9201.07, Los Angeles, CA",1672,85,1395,100,277,66
14000US06037920108,6037920108,"Census Tract 9201.08, Los Angeles, CA",1749,38,1317,92,432,88
14000US06037920109,6037920109,"Census Tract 9201.09, Los Angeles, CA",2079,78,1411,129,668,118
14000US06037920110,6037920110,"Census Tract 9201.10, Los Angeles, CA",981,18,697,51,284,50
14000US06037920111,6037920111,"Census Tract 9201.11, Los Angeles, CA",894,54,804,73,90,50
14000US06037920112,6037920112,"Census Tract 9201.12, Los Angeles, CA",1478,26,1061,96,417,100
14000US06037920114,6037920114,"Census Tract 9201.14, Los Angeles, CA",2258,90,1167,145,1091,156
14000US06037920115,6037920115,"Census Tract 9201.15, Los Angeles, CA",1518,57,1119,95,399,97
14000US06037920116,6037920116,"Census Tract 9201.16, Los Angeles, CA",1640,48,1508,69,132,60
14000US06037920118,6037920118,"Census Tract 9201.18, Los Angeles, CA",1803,41,1637,89,166,72
14000US06037920119,6037920119,"Census Tract 9201.19, Los Angeles, CA",537,12,507,28,30,27
14000US06037920200,6037920200,"Census Tract 9202, Los Angeles, CA",0,17,0,17,0,17
14000US06037920303,6037920303,"Census Tract 9203.03, Los Angeles, CA",622,43,280,50,342,53
14000US06037920312,6037920312,"Census Tract 9203.12, Los Angeles, CA",2101,80,997,114,1104,124
14000US06037920313,6037920313,"Census Tract 9203.13, Los Angeles, CA",1530,52,1252,92,278,82
14000US06037920314,6037920314,"Census Tract 9203.14, Los Angeles, CA",935,22,663,56,272,50
14000US06037920322,6037920322,"Census Tract 9203.22, Los Angeles, CA",996,65,788,80,208,64
14000US06037920326,6037920326,"Census Tract 9203.26, Los Angeles, CA",2446,121,1219,156,1227,196
14000US06037920328,6037920328,"Census Tract 9203.28, Los Angeles, CA",835,45,403,45,432,54
14000US06037920329,6037920329,"Census Tract 9203.29, Los Angeles, CA",2942,90,1756,194,1186,187
14000US06037920330,6037920330,"Census Tract 9203.30, Los Angeles, CA",1538,45,796,111,742,118
14000US06037920331,6037920331,"Census Tract 9203.31, Los Angeles, CA",1247,28,953,95,294,95
14000US06037920332,6037920332,"Census Tract 9203.32, Los Angeles, CA",582,27,408,56,174,51
14000US06037920334,6037920334,"Census Tract 9203.34, Los Angeles, CA",2184,96,1371,133,813,148
14000US06037920336,6037920336,"Census Tract 9203.36, Los Angeles, CA",1644,67,459,80,1185,92
14000US06037920337,6037920337,"Census Tract 9203.37, Los Angeles, CA",1915,57,529,96,1386,111
14000US06037920338,6037920338,"Census Tract 9203.38, Los Angeles, CA",1741,40,1555,98,186,94
14000US06037920339,6037920339,"Census Tract 9203.39, Los Angeles, CA",2383,128,1792,157,591,159
14000US06037930101,6037930101,"Census Tract 9301.01, Los Angeles, CA",35,16,24,12,11,10
14000US06037930200,6037930200,"Census Tract 9302, Los Angeles, CA",147,45,121,46,26,22
14000US06037930301,6037930301,"Census Tract 9303.01, Los Angeles, CA",195,37,176,36,19,16
14000US06037980001,6037980001,"Census Tract 9800.01, Los Angeles, CA",0,12,0,12,0,12
14000US06037980002,6037980002,"Census Tract 9800.02, Los Angeles, CA",0,12,0,12,0,12
14000US06037980003,6037980003,"Census Tract 9800.03, Los Angeles, CA",0,12,0,12,0,12
14000US06037980004,6037980004,"Census Tract 9800.04, Los Angeles, CA",0,12,0,12,0,12
14000US06037980005,6037980005,"Census Tract 9800.05, Los Angeles, CA",0,12,0,12,0,12
14000US06037980006,6037980006,"Census Tract 9800.06, Los Angeles, CA",0,12,0,12,0,12
14000US06037980007,6037980007,"Census Tract 9800.07, Los Angeles, CA",0,12,0,12,0,12
14000US06037980008,6037980008,"Census Tract 9800.08, Los Angeles, CA",17,29,0,12,17,29
14000US06037980009,6037980009,"Census Tract 9800.09, Los Angeles, CA",0,12,0,12,0,12
14000US06037980010,6037980010,"Census Tract 9800.10, Los Angeles, CA",56,18,24,9,32,17
14000US06037980013,6037980013,"Census Tract 9800.13, Los Angeles, CA",0,12,0,12,0,12
14000US06037980014,6037980014,"Census Tract 9800.14, Los Angeles, CA",5,7,0,12,5,7
14000US06037980015,6037980015,"Census Tract 9800.15, Los Angeles, CA",350,62,0,12,350,62
14000US06037980018,6037980018,"Census Tract 9800.18, Los Angeles, CA",0,12,0,12,0,12
14000US06037980019,6037980019,"Census Tract 9800.19, Los Angeles, CA",65,17,53,18,12,10
14000US06037980020,6037980020,"Census Tract 9800.20, Los Angeles, CA",0,12,0,12,0,12
14000US06037980021,6037980021,"Census Tract 9800.21, Los Angeles, CA",8,8,8,8,0,12
14000US06037980022,6037980022,"Census Tract 9800.22, Los Angeles, CA",0,12,0,12,0,12
14000US06037980023,6037980023,"Census Tract 9800.23, Los Angeles, CA",0,12,0,12,0,12
14000US06037980024,6037980024,"Census Tract 9800.24, Los Angeles, CA",75,22,51,13,24,19
14000US06037980025,6037980025,"Census Tract 9800.25, Los Angeles, CA",0,12,0,12,0,12
14000US06037980026,6037980026,"Census Tract 9800.26, Los Angeles, CA",4,7,4,7,0,12
14000US06037980028,6037980028,"Census Tract 9800.28, Los Angeles, CA",0,12,0,12,0,12
14000US06037980030,6037980030,"Census Tract 9800.30, Los Angeles, CA",0,12,0,12,0,12
14000US06037980031,6037980031,"Census Tract 9800.31, Los Angeles, CA",24,27,0,12,24,27
14000US06037980033,6037980033,"Census Tract 9800.33, Los Angeles, CA",16,23,0,12,16,23
14000US06037990100,6037990100,"Census Tract 9901, Los Angeles, CA",0,12,0,12,0,12
14000US06037990200,6037990200,"Census Tract 9902, Los Angeles, CA",0,12,0,12,0,12
14000US06037990300,6037990300,"Census Tract 9903, Los Angeles, CA",0,12,0,12,0,12